la zona	area (not "el área")
el cuerpo	body
el número	number
pedir	to ask for, to request
él	he
el principio	principle, beginning
público	public
cinco	five
antes	before (something)
nadie	nobody
poco	little, few
desarrollar	to develop
la madre	mother
mil	thousand
conseguir	to get, to obtain (c..)
el derecho	right (legal, not direction)
por	by, for
el estudio	study, studio
todavía	still (yet) (not "aún")
oír	to hear
sentar	to sit
recordar	to remember
sobre	on, about
la realidad	reality
la idea	idea
el desarrollo	development
la voz	voice
ah	ah
la población	population
lograr	to achieve (l...)
a través de	through, across
junto	together
caer	to fall
caerse	to fall down (reflexive)
establecer	to establish (e.., not "entablar")
terminar	to terminate
el movimiento	movement
la situación	situation
la universidad	university
la muerte	death
distinto	distinct, different  (not "diferente")
español	Spanish
el cambio	change
el nivel	level
diferente	different
la luz	light
entender	to understand (not comprender)
tal	such
largo	long
aún	still, yet (not "todavía")
alcanzar	to reach, catch up with, achieve
el campo	field (country, land)
la cabeza	head
la calle	street
antiguo	old, ancient, antique
el medio	half (Noun) (not "la mitad")
el hecho	fact; event
hecho	done
la mayoría	majority
el poder	power
el paso	step (w/foot)
el Dios	God
la puerta	door
la actividad	activity
la especie	species
el interés	interest
cambiar	to change, to shift
el programa	program
internacional	international
ocurrir	to happen (o...)
ocurrirse	to occur to (a thought or idea) (reflexive)
ciento	hundred
cientos de	hundreds of
la política	politics; policy
el río	river
estudiar	to study
el servicio	service
la región	region
México	Mexico
acabar	to end, to finish (a...)
incluso	even, including
el norte	north
la sociedad	society
dirigir	to direct (d...)
sacar una foto	to take a picture
sacar	to take out, to extract, to remove (s..)
varios	several
la razón	reason (not porqué)
ayer	yesterday
la clase	class
la década	decade
Europa	Europe
la república	republic
la gracia	grace
incluir	to include
el fondo	background, bottom, backyard
la acción	action
leer	to read
el sentido	sense (not "sentimiento" or "sensación")
destacar	to emphasize, to highlight (d...)
obtener	to obtain, to get (o...)
continuar	to continue (c...)
todo	all
primer	first (used before singular masculine nouns)
primero	first
el primero	(the) first
explicar	to explain
el período	period (not "tiempo" or "época")
la iglesia	church
el papel	paper, role
el sur	south
servir	to serve
el don	gift (talent)
don	Mister (the masculine equivalent of doña)
allá	there, over there
especial	special
el equipo	team, equipment
escuchar	to listen
la escuela	school
el hermano	brother
la hermana	sister
el mes	month
próximo	next, closest
el proyecto	project
el teatro	theater
el producto	product
la orden	order (a command)
el orden	order (as in we need a bit of order in here)
partir	to cut, leave, depart
la serie	series (TV, sports) (not  "el serial")
el serial	TV series (not "la serie")
mostrar	to show
el miembro	member (not "el socio")
el color	colour, color
representar	to represent
tocar	to touch, to play  an instrument
la cultura	culture
mundial	worldwide
el mar	sea
la paz	peace
la producción	production
el valor	value, courage
blanco	white
la información	information
no	no
la cara	face (not "rostro")
seis	six
ofrecer	to offer
la elección	election, choice
el mercado	market
ello	it
la base	base, foundation (not "la basa")
el aire	air
la condición	condition
reconocer	to recognize
real	real; royal
ocupar	to occupy
la autoridad	authority
el pesar	sorrow
la organización	organization
el elemento	element
Francia	France
la respuesta	answer, response, reply (r.., not "la réplica")
el amor	the love (noun)
tanto	so much
acercarse	to approach, to get closer (not "aproximarse" or "abordar")
acercar	to bring closer
difícil	difficult
la investigación	research, investigation
iniciar	to initiate, start
jugar	to play
correr	to run
eso	that (neutral)
el sector	sector
la edad	age
dedicar	to dedicate
levantar	to lift, pick up, to raise (l...)
bastante	enough, rather
la tarde	afternoon
medio	half (Adj.)
el pie	foot
necesario	necessary
la imagen	image
el aspecto	aspect; appearance, look
el dinero	money (d...)
señalar	to point out, indicate, mark (s...)
la cantidad	quantity, amount
pagar	to pay (for)
intentar	to try (not "tratar")
el director	director
ninguno	none
el autor	author
el rey	king
santo	holy
el santo	saint
aceptar	to accept
nacer	to be born
usar	to use
el modo	way (of doing something), manner, mode
el sol	sun
la posibilidad	possibility
el banco	bank
el dólar	dollar
diez	ten
anterior	previous, former (not previo)
tampoco	neither (not "ni")
el capital	capital (money)
el juego	game, play
libre	free (at liberty, available)
pronto	soon
el término	term, terminus
el estilo	style
el efecto	effect
constituir	to constitute, to set up
negro	black
el ministro	minister
comer	to eat
la carrera	career; race (speed); university degree/major
el español	Spanish
natural	natural
el resto	rest, remainder
el joven	young person
europeo	european
la función	function
la costa	coast
María	Mary
Cuba	Cuba
el objeto	object
disponer	to arrange, to provide, to stipulate, to dispose
meter	to put into, to stick in, to insert, to introduce (not introducir)
central	central
la educación	education
la estructura	structure
julio	July
construir	to construct, to build
la nación	nation
militar	military, militaristic
el militar	soldier (m...)
el territorio	territory
la economía	economy
la isla	island
conocido	known (person, place)
provocar	to provoke, to cause
el espacio	space
realmente	really (r...)
el	the (masc)
cerca	near, nearby, close (not "cercano")
el suelo	ground, floor, soil
cuál	which
comprar	to buy
ayudar	to help
diverso	diverse
el cabo	extremity (not "la extremidad"), end, end piece
el control	control
el precio	price, fee, charge
el muchacho	guy, boy (m..., not "el mozo")
francés	French
el animal	animal
el minuto	minute
el peso	weight
la necesidad	need, necessity
la comunidad	community
elegir	to elect, to choose (not escoger)
suceder	to succeed; to happen
subir	to go up, to rise, to ascend (s.., not "surgir"); to upload
la libertad	liberty, freedom
el origen	origin
el candidato	candidate
publicar	to publish
asegurar	to assure
asegurarse	to make sure
el recurso	resource
la ocasión	occasion
la falta	lack (not carencia)
la diferencia	difference
la seguridad	security, safety
el ejército	army
detener	to detain
la policía	police
mediante	through, by means of (not "por medio de")
el viaje	journey, trip (not recorrido or trayecto)
la literatura	literature
el profesor	professor, teacher (not maestro)
la cámara	camera
indicar	to indicate
la presencia	presence
aumentar	to increase (not incrementar)
la energía	energy
la posición	position
sufrir	to suffer
el uso	use, usage (not utilización or aplicación )
dónde	where
el museo	museum
el resultado	result, outcome
la enfermedad	disease
el material	material (physical substance); subject matter
participar	to participate
el brazo	arm
apenas	hardly
el congreso	congress; conference
la materia	matter, substance, material; subject (of a course of study)
moderno	modern
tercer	third
la fuente	fountain, source
emplear	to employ
surgir	to arise; to emerge; to rise (s..., not “subir”)
evitar	to avoid
la decisión	decision
responder	to respond, to reply (not contestar or replicar)
solamente	only (not "únicamente")
mover	to move, to shift
la experiencia	experience
el esfuerzo	effort
el igual	equal
menor	minor, lesser, younger
el jefe	boss
la planta	plant
la duda	doubt
cultural	cultural
la reforma	reform
la institución	institution
popular	popular
británico	British
enorme	huge, enormous
la introducción	introduction
siete	seven
afirmar	to state, to affirm
ambos	both
olvidar	to forget
la boca	mouth
cubrir	to cover, to cover up, to conceal (c..)
la causa	cause
extender	to extend
acordar	to agree (a.., not "acceder")
acordarse	to remember (reflexive) (a...)
la pintura	painting
la influencia	influence
repetir	to repeat
posible	possible
alguien	someone
la cuestión	question (matter, regard)
la importancia	importance
el viejo	old man (not anciano)
la dirección	direction, address
me	me, to me
la técnica	technique, skill; technician (fem.)
religioso	religious
el asunto	matter, issue
el artista	artist
abierto	open
unir	to unite
vender	to sell
ser	to be (used for lasting attributes)
el ser	being
el favor	favour
el sueño	dream
referir	to refer
demasiado	too much
echar	to throw, to cast (not arrojar, lanzar, or tirar)
comercial	commercial
oficial	official
malo	bad
la unión	union (u...)
regresar	to return, to come back (not "volver" or "devolver")
observar	to observe
rojo	red (not "colorado")
obligar	to obligate, to oblige; to force
la campaña	campaign
la pieza	piece (not "trozo" or "pedazo")
numeroso	numerous
la unidad	unit, unity
el domingo	Sunday
alemán	German
la mesa	table
la superficie	surface
la opinión	opinion (not parecer)
la comunicación	communication
apoyar	to support
el puerto	port (maritime)
la compañía	company (not "la empresa")
la atención	attention
expresar	to express
medir	to measure
la prensa	press (the newspaper industry)
la novela	novel
la industria	industry
el consejo	advice
valer	to be worth
el habitante	inhabitant
faltar	to lack (not carecer)
el curso	course (educ.); course  (direction, progress) (c..)
la construcción	construction
el comercio	commerce
cerrar	to close
ocho	eight
Antonio	Anthony
la carta	letter (written document); menu; playing card; map
caminar	to walk (c...)
preparar	to prepare
amplio	ample, wide, spacious (not ancho)
para	to, for
la sangre	blood
histórico	historical
el plan	plan
especialmente	especially
la comisión	commission
el silencio	silence
reunir	to gather, reunite
reunirse	to reunite, to meet, to gather (reflexive)
América	America
anunciar	to announce; to advertise
matar	to kill
mayo	May
interno	internal
el edificio	building
el escritor	writer
bajar	to go down, lower, turn down, download
Alemania	Germany
superior	superior, top
la capacidad	capacity
el largo	length
privado	private
la consecuencia	consequence
abandonar	to abandon
cuanto	as much, as many, as much as (c..)
determinado	determined, specific (not decidido or resuelto)
el método	method
verdadero	true, real
el rico	the rich
lanzar	to throw, to launch (not arrojar, echar, or tirar)
la piedra	stone
el maestro	teacher
el corazón	heart
el colegio	college, high school (c..)
independiente	independent
acompañar	to accompany
físico	physical
la naturaleza	nature (not natural)
personal	personal
el oro	gold (the metal, not the color)
occidental	western
el interior	interior
importar	to be important, to matter
la oportunidad	opportunity
el conocimiento	knowledge (not saber)
el conjunto	group (c..., not "el colectivo")
informar	to report (not "reportar"); to inform (not "enterar")
la pregunta	question (query)
interesar	to interest
interesarse	to be interested (not "estar interesado")
cuatro	four
el carácter	character, personality (not "personalidad" or "personaje")
la prueba	test, proof
el poeta	poet
electoral	electoral
completo	complete
cantar	to sing
el futuro	future (not porvenir)
la lucha	fight (not pelea)
actuar	to act, perform, play
proponer	to propose (not plantear)
la ciencia	science
significar	to mean, to signify
depender	to depend
la flor	flower
imponer	to impose
aprender	to learn
el dato	piece of information, datum
la sala	living room (not salón)
alrededor	around, round, about
separar	to separate (not apartar)
la tradición	tradition
vos	you (singular, more informal than "tú")
enviar	to send (not "mandar")
la madera	wood
París	Paris
la mitad	half, middle, midpoint (Noun) (not "el medio")
denominar	to designate, to name (not "designar" or "nombrar")
resolver	to solve, to resolve, to decide
el imperio	empire
el modelo	model; fashion model (male)
la crisis	crisis
fijar	to fix, set
el personaje	personage, important person
el trabajador	worker (not obrero)
desaparecer	to disappear
el conflicto	conflict
celebrar	to celebrate
el miedo	fear (m...)
el organismo	organism
la defensa	defense
desear	to desire (not "querer")
la formación	formation (training)
atrás	behind, back (not detrás)
el metro	metro, subway
la salud	health
la calidad	quality (calibre)
civil	civil
el civil	civilian
el apoyo	support (not soporte)
el rostro	face (figurative, countenance)
menos	minus
el acto	act
la mirada	look, peek, glance (not "el vistazo" or "la ojeada")
quizá	perhaps
total	total
cuarto	fourth
fundamental	fundamental
el objetivo	objective
sostener	to sustain, support, hold up (not sustentar)
entregar	to deliver
el compañero	colleague, companion, partner, mate (not colega)
avanzar	to advance
aplicar	to apply (not solicitar)
el ministerio	ministry
la vía	route, way (v...)
el crecimiento	growth
capaz	able, capable
la propiedad	property
científico	scientific
el científico	scientist
la provincia	province
musical	musical
el musical	musical
situar	to situate
basar	to base, to found (b...)
la orquesta	orchestra
la creación	creation
Italia	Italy
el arma	weapon
conservar	to conserve, keep, preserve
controlar	to control
la expresión	expression
el departamento	department
declarar	to declare
la televisión	television, TV
la actitud	attitude
defender	to defend
el motivo	motive, reason
el instrumento	instrument
adelante	forward
adquirir	to acquire
profesional	professional
el profesional	professional
el público	public
afectar	to affect, upset, damage
junio	June
el médico	doctor (male, not "el doctor")
salvar	to save, to rescue (not guardar or ahorrar)
negar	to deny, to refuse (not "rechazar")
firmar	to sign (a document) (not "suscribir")
el golpe	blow, knock, bump
el texto	text
el pan	bread
la plata	silver; money (Lat Am)
decir	to say, to tell
la piel	skin
el artículo	article (not reportaje)
la cama	bed
la pared	wall (p...)
fundar	to found, to establish, to base (f..., not "fundamentar")
la justicia	justice
componer	to compose; to repair
la fecha	(calendar) date
cortar	to cut
la célula	cell (biology)
Chile	Chile
la operación	operation
el viento	wind
el sitio	site, place
la victoria	victory
romper	to break
la ayuda	help (not auxilio)
comentar	to comment
cubano	Cuban
recoger	to pick up, gather up
el caballo	horse
precisamente	precisely
local	local
la radio	radio (the broadcasting medium)
literario	literary
enfrentar	to confront (e.., not "encarar")
común	common (...n)
la solución	solution
interesante	interesting
hallar	to find (not "encontrar")
generar	to generate
grave	serious (not "serio"), critical, severe
suficiente	sufficient, enough (s...)
la revolución	revolution
el cielo	sky
el reino	kingdom
el inglés	English
el diario	newspaper (not "periódico")
el régimen	regime
el premio	prize
la niña	child (girl)
pertenecer	to belong, to belong to
aprobar	to approve; to pass (an exam); to pass (a law)
similar	similar (not "semejante" or "parecido")
el comienzo	start, beginning (c..)
la estrella	star
la presión	pressure
enero	January
la cruz	cross, crucifix
treinta	thirty
pretender	to aspire, to expect, to attempt (p...)
despertar	to wake up (someone else)
la distancia	distance
el dirigente	leader (not gobernante, líder, or mandatario)
el voto	vote
exigir	to demand, to require (not demandar or requerir)
la mamá	mom
tirar	to throw, to toss (not arrojar, echar, or lanzar)
la corriente	current (river, electricity)
la corte	court [of law] (not juzgado or tribunal)
jamás	never (j...)
poseer	to possess, own
el pasado	past
obstar	to obstruct, to hinder, to impede
la constitución	constitution
la práctica	practice
vestir	to dress
la temperatura	temperature
la abuela	grandmother
introducir	to introduce, to insert, to bring in (not meter)
la visita	visit
la noticia	news (singular)
el secretario	secretary
cruzar	to cross (not atravesar)
el dedo	finger
el dolor	pain, sorrow (not "la pena")
veinte	twenty
finalmente	finally
quizás	perhaps
enseñar	to teach, to show
parar	to stop
la velocidad	speed (v...)
la revista	magazine (periodical)
la generación	generation
el contacto	contact
contestar	to answer, to reply (not replicar or responder)
arriba	up, above (describing a higher area)above (describing a higher area); upstairs
el ex	ex
el pensamiento	thought
joven	young (not juvenil)
el respecto	respect, regard (e.g. with respect to...)
el calor	heat
democrático	democratic
reír	to laugh (not reflexive)
quitar	to take away, to eliminate, to remove (q..)
el presente	present (time, tense)
la altura	height
el estudiante	student
el jugador	player
la característica	characteristic
guardar	to guard, to keep, to save (not salvar or ahorrar)
la exposición	exposition; exhibition; trade show
el terreno	terrain, ground
la existencia	existence
colocar	to place, to put (not poner)
el alma	the soul
rápido	fast
adoptar	to adopt
artístico	artistic
el concepto	concept
la poesía	poetry
el sonido	sound
el grado	degree (temperature, angle); extent; rank (mil.)
diciembre	December
retirar	to retire, withdraw
el papá	dad
famoso	famous (f...)
la memoria	memory (m...)
añadir	to add
la ventana	window
el cuento	story (not historia)
gritar	to shout, yell, scream
oscuro	dark
dividir	to divide
la responsabilidad	responsibility
rodear	to circle, surround
la oposición	opposition
marzo	March
plantear	to pose (e.g. a question), to propose (not proponer)
el análisis	analysis
el espíritu	spirit
determinar	to determine
la administración	administration
la peseta	money (p...), small amount of money (figurative)
el negocio	business, company; transaction, deal
el fuego	fire (not "el incendio")
la actualidad	present (moment in time -- not el presente)
compartir	to share
la suerte	luck
la hoja	leaf, sheet (of paper)
la pierna	leg
consistir	to consist
superar	to overcome (not remontar)
la lluvia	rain (not "chaparrón")
viajar	to travel
abajo	down (a...); downstairs
el documento	document (not escrito)
supuesto	supposed; assumed
el recuerdo	memory  (specific recollection) (r...); souvenir
la sombra	shadow
el hospital	hospital
reflejar	to reflect (show)
absoluto	absolute
advertir	to warn (not avisar)
el concierto	concert
concluir	to conclude (not rematar)
funcionar	to function
federal	federal
octubre	October
serio	serious (not "grave")
definir	to define
vivo	alive
industrial	industrial
la carne	meat
el alumno	student (a...)
la fiesta	party, festivity
nueve	nine
tradicional	traditional
el factor	factor
la entrada	entrance (not "ingreso"); ticket
directo	direct
la inversión	investment
el deseo	desire
costar	to cost
el instituto	institute
el/la líder	leader (not dirigente, gobernante, or mandatario)
totalmente	totally
técnico	technical
septiembre	September
la propuesta	proposal (not proposición)
el género	gender, kind
alejar	to move (something) away
clásico	classical
exterior	exterior, external (not "externo")
la oficina	office (o...)
visitar	to visit
marcar	to mark
el café	coffee
cuidar	to look after, to take care of (c...)
el tío	uncle
notar	to notice, to note (not "darse cuenta")
el riesgo	risk
cincuenta	fifty
duro	hard, firm
Colombia	Colombia
el ejecutivo	executive, manager
impedir	to impede
prácticamente	practically
ejercer	to exercise, to practice
dominar	to dominate
el tratamiento	treatment (not trato); medical treatment
el general	general (military)
el individuo	individual
bello	beautiful (b...)
integrar	to integrate
la alianza	alliance
la etapa	stage, phase (progress)
el ciudadano	citizen
China	China
la arquitectura	architecture
la venta	sale
la ropa	clothes, clothing
la pena	pain, pity, sorrow (not "dolor")
el par	pair (not "pareja")
el tamaño	size (not "la talla" or "el talle")
el fenómeno	phenomenon
la llamada	call, phone call
el barco	boat, ship (b... not buque)
el juicio	trial, judgement
la letra	letter (ABC); lyrics (of song)
el transporte	transport
la labor	labor, task
simple	simple (not sencillo)
el abogado	lawyer, attorney (not procurador)
escapar	to escape (not huir)
la costumbre	custom, habit (not "el hábito")
simplemente	simply (not "sencillamente")
invitar	to invite, to treat
nombrar	to name, mention, nominate, refer to (not "denominar")
la escena	scene
recorrer	to travel across, to tour
la masa	dough, mass
la frecuencia	frequency
financiero	financial
proporcionar	to provide, to supply (not proveer or suministrar)
el diputado	deputy (political representative, MP)
el piso	floor, story (of a building), apartment (US), flat (UK)
el ingreso	admission, entry (e.g. to school, hospital)
básico	basic
el bosque	forest
la reacción	reaction
romano	Roman
el canal	channel
el alimento	food (a.., not "la alimentación")
aprovechar	to make the most of
italiano	Italian
insistir	to insist
el barrio	neighborhood (not "el vecindario")
rechazar	to reject
Inglaterra	England
el lenguaje	language (sign, body, computer)
proteger	to protect
el ataque	attack (not atentado)
frío	cold
la versión	version
manifestar	to manifest, to reveal, to show
oriental	eastern
la demanda	demand (not exigencia)
la página	page
preocupar	to worry (not "inquietar")
el palacio	palace
el detalle	detail
el cine	cinema
analizar	to analyze
bien	well (not pues)
Perú	Peru
la participación	participation
la colección	collection
la declaración	declaration
el rato	while, time
unido	close, united
final	final
el poema	poem
agregar	to aggregate, to add
posterior	later, after (p...)
el destino	destiny, destination
eléctrico	electric
actualmente	currently, nowadays
la asociación	association
la esperanza	hope
el pintor	painter
el pelo	hair (body) (not cabello)
Guatemala	Guatemala
la asamblea	assembly, meeting
la conversación	conversation
la red	network
la independencia	independence
u	or (when followed by "o" or "ho")
el teléfono	phone
la máquina	machine
mío	mine
el aumento	increase, rise (not alza or incremento)
mejorar	to improve
mexicano	Mexican
la tendencia	tendency, trend
griego	Greek
caber	to fit, to squeeze in
organizar	to organize
contemplar	to contemplate
febrero	February
Bolivia	Bolivia
el gesto	gesture (not ademán)
el gas	gas
la marcha	march, walk, hike
el periodista	journalist
recuperar	to recuperate; to retrieve, get back
la esposa	wife
asumir	to assume, to take on
el valle	valley
puro	pure
la enseñanza	teaching
encima	above, over; furthermore
la democracia	democracy
el compositor	composer
el habano	cigar (h...)
americano	American (not estadounidense)
la visión	vision
químico	chemical
reciente	recent
incorporar	to incorporate
inmediato	immediate
azul	blue
convencer	to convince
sorprender	to surprise (not extrañar)
mencionar	to mention
requerir	to require (not exigir)
el pobre	poor
máximo	maximum
la tarea	task, homework
aproximadamente	approximately
el periódico	newspaper (not "diario")
el tribunal	tribunal, court [of law] (not corte or juzgado)
el vecino	neighbor
la conciencia	conscience (judgement of right and wrong); awareness
Brasil	Brazil
exponer	to expose, to exhibit (not exhibir)
el informe	report (piece of information) (i...)
el perro / la perra	dog
someter	to submit
contribuir	to contribute (not aportar)
bonito	pretty
la espalda	back (anatomy)
la frontera	border, frontier (not borde)
la religión	religion
el avance	advance (not "el adelanto")
argentino	Argentinian
la edición	edition
implicar	to implicate
elevar	to elevate
recién	recently (not recientemente)
el sentimiento	feeling (not "el sentir")
el gusto	taste (not sabor)
concreto	concrete
el juez	judge (not magistrado)
la batalla	battle
describir	to describe
atender	to attend to, to look after
el parque	park
transformar	to transform
el propósito	purpose (not finalidad)
Japón	Japan
el seguro	insurance
extraordinario	extraordinary
coger	to catch (bus, plane etc), grasp, take
la caja	box; cash register
la comida	food; meal
el comité	committee
la fase	phase
el jardín	garden
Roma	Rome
identificar	to identify
cuarenta	forty
el hotel	hotel
extranjero	foreign
doce	twelve
el marido	husband (not esposo)
la luna	moon
oponer	to oppose
el verano	summer
la división	division
el idioma	language
prestar algo	to lend something
el peligro	danger
la copa	cup, alcoholic drink
revelar	to reveal
Jesús	Jesus
el triunfo	triumph
inglés	English
la salida	exit
la presidencia	presidency
encargar	to entrust; order (when shopping)
la tropa	troop
la dificultad	difficulty
la negociación	negotiation
la circunstancia	circumstance
destruir	to destroy (not destrozar)
detrás	behind, back (not atrás)
el plazo	period (of time), installment
luchar	to fight (not combatir or pelear)
la entidad	entity
el error	error
el Papa	Pope
la tecnología	technology
cobrar	to charge, to cash
complejo	complex
limitar	to limit
el límite	limit
el extranjero	foreigner; abroad
soviético	Soviet
la raíz	root
lejos	far away (l...) (not lejano)
el tono	tone
el intento	attempt
el investigador	investigator
aquello	that one (over there) (neutral)
norteamericano	North American
amar	to love (not "querer")
el extremo	extreme
la representación	representation
verde	green
la filosofía	philosophy
la biblioteca	library
discutir	to discuss, to argue
el diálogo	dialogue
estatal	state, national (not "nacional")
la habitación	room (h...)
confirmar	to confirm
la canción	song
el hierro	iron (metal)
el volumen	volume
la nota	note
el político	politician
la violencia	violence
la regla	rule (not "reglamento")
el municipio	municipality (not municipalidad)
la señal	signal; sign (traffic) (not "signo" or "seña")
el metal	metal
acá	here, over here (not "aquí")
la fe	faith
la estación	station; season (of the year)
el instante	instant
la pérdida	loss
la crítica	criticism
la carga	load, cargo (not "el cargamento")
Argentina	Argentina
el gobernador	governor
el vehículo	vehicle
el grito	shout, yell, scream, cry
sonar	to ring, sound, be pronounced
la selección	selection (not "el surtido")
vencer	to conquer, overcome (not conquistar)
lleno	full, filled up (not pleno)
seco	dry
el paciente	patient
raro	strange, rare (not extraño)
citar	to quote, to cite; to make an appointment
anual	annual
asistir	to attend; to assist
hermoso	beautiful (h...)
el ruido	noise
el mecanismo	mechanism (not dispositivo)
ay	ouch
cristiano	Christian
definitivo	definitive
el matrimonio	marriage (not  "el casamiento" or "la boda")
el labio	lip
tender	to hang out; to spread out; to hold out (one's hand)
durar	to last
la variedad	variety
el nacional	national (citizen of a nation)
la conferencia	conference
cualquiera	anybody; whichever
normal	normal
la montaña	mountain (not "monte")
cercano	nearby, near, close (not "cerca")
lo	it (l...)
cerrado	closed
la cifra	number, digit, figure (not "número")
la cadena	chain
el escenario	stage, setting
el pecho	chest (anatomy)
el petróleo	petroleum, crude oil
ordenar	to order (not mandar)
India	India
la evolución	evolution
familiar	family, familiar
exactamente	exactly, precisely (not justamente)
la competencia	competition (rivalry); competence
debajo	underneath
seguro	safe, certain
montar	to mount
distinguir	to distinguish
sonreír	to smile
la risa	laughter (not carcajada)
Rusia	Russia
pleno	full (not lleno)
escaso	scarce
el agente	agent
chino	Chinese
el compromiso	commitment, obligation, compromise; engagement
caracterizar	to characterize
principalmente	principally
la tasa	rate, valuation (not tarifa)
la moneda	coin; currency (not "la divisa")
trasladar	to transfer, to move (not transferir)
específico	specific
variar	to vary
la composición	composition
respetar	to respect
la roca	rock (r...)
solicitar	to solicit
instalar	to install
católico	Catholic
urbano	urban
la intención	intention
presidencial	presidential
la aplicación	use (a..); application
entero	entire, whole
el presupuesto	budget, estimate
destinar	to allocate, devote
el debate	debate
intenso	intense
el contrario	contrary
atravesar	to cross, to pass through (not cruzar)
probablemente	probably
el responsable	person responsible; culprit (not "el culpable"), person in charge
proceder	to proceed
el patio	patio, courtyard
el respeto	respect (esteem, admiration)
el sábado	Saturday
sencillo	simple (not "simple")
moral	moral
el gasto	spending, expense
aun	even (a..)
hasta	until
el kilómetro	kilometer
la impresión	impression
influir	to influence (not "incidir")
la norma	the norm, standard
el ritmo	rhythm
el empleo	employment
la colonia	colony; cologne
directamente	directly
el diseño	design
el campesino	peasant
adecuado	adequate
acusar	to accuse
judicial	judicial
la vuelta	turn, turning, other side (not giro or turno)
el empresario	businessman (e..)
ubicar	to find, locate; to place (L. Am.) (not localizar)
original	original
pintar	to paint
quince	fifteen
latino	Latin
el núcleo	nucleus
el olor	odor, smell
la capa	cape, cloak [clothing] (not manto)
la droga	drug
el león	lion
transmitir	to transmit
legislativo	legislative
el soldado	soldier (not "militar")
seguramente	surely, probably; certainly (not ciertamente)
la sonrisa	smile
eliminar	to eliminate
el continente	continent
la vivienda	housing
el viernes	Friday
conceder	to concede; to grant, to give
sexual	sexual
cien	one hundred
la temporada	season (sports, fruit); period of time
tranquilo	quiet, calm, peaceful (t..)
el hogar	home (not "casa")
la medicina	medicine
la bolsa	bag (not "el bolso"); stock market
arrastrar	to drag
el descubrimiento	discovery
sustituir	to substitute
positivo	positive
derecho	right
la aparición	appearance (process of appearing), apparition
a menudo	often
el puesto	post, position (not posición)
nuclear	nuclear
emitir	to emit
la ventaja	advantage
el vino	wine
contrario	contrary
el ciclo	cycle (unit of time)
la sensación	sensation, feeling
suyo	his
beber	to drink
el cultivo	cultivation; crop
la fotografía	photography
legal	legal (not jurídico)
interpretar	to interpret
doña	Mrs. (d...)
interior	interior
la reina	queen
la preocupación	worry
el hombro	shoulder
probar	to test, to try (on clothes, food)
posteriormente	subsequently
la víctima	victim
la rama	branch (of tree, family, subject)
saltar	to jump (not brincar)
girar	to gyrate (to turn)
la frase	phrase
aéreo	aerial
el torneo	tournament
la escala	scale (maps, music); stopover (travel)
el lunes	Monday
más	plus, more
la gana	desire, wish, win (not "deseo")
el mensaje	message
grabar	to record
Barcelona	Barcelona
el dibujo	drawing
generalmente	generally
el marco	frame, doorframe; framework
Londres	London
la potencia	potency, power
la sustancia	substance
el espejo	mirror
el beneficio	benefit
el chico	boy (not "niño" or "muchacho")
comunista	communist
estimar	to estimate
la agencia	agency
el músico	musician
el vidrio	glass (material)
rico	rich, tasty, yummy
el deporte	sport
el dominio	dominion
acostumbrar	to accustom
preciso	precise
la junta	board (committee), meeting
esconder	to hide, to conceal (not "ocultar")
el tejido	fabric (not tela)
comprobar	to check (not "chequear" or "checar"), prove, verify
Miami	Miami
intervenir	to intervene
el emperador	emperor
el paisaje	landscape, scenery
pegar	to stick, adhere, paste (including on computer)
completamente	completely (c..)
Asia	Asia
la escultura	sculpture
el crédito	credit
el disco	disc (e.g. record, vinyl)
cometer	to commit
la izquierda	left
la partícula	particle
asimismo	in the same manner, likewise (not "igualmente", or "también")
investigar	to investigate
el acontecimiento	event, occurrence (a...)
cuánto	how much
merecer	to merit, deserve
alguno	some (any)
agrícola	agricultural (not agrario)
la carretera	highway, road (not autopista)
el hambre	hunger
pobre	poor
la resistencia	resistance
el salvador	savior
satisfacer	to satisfy
el oeste	west
envolver	to wrap
aportar	to contribute (not contribuir)
el criterio	criterion
el frío	cold
el signo	sign, symbol (not seña,  señal or símbolo)
universal	universal
el club	club
el ejercicio	exercise
la juventud	youth (concept)
ruso	Russian
el procedimiento	procedure (not trámite)
mediado	half-way through
el diente	tooth
etcétera	et cetera
comunicar	to communicate
la confianza	confidence, trust
acudir	to come, to go, to show up
el total	total
coincidir	to coincide
la lista	list
la protección	protection
la fundación	foundation (type of financial inst.); act of founding
individual	individual, separate
el gen	gene
la firma	signature
admitir	to admit
conmigo	with me
el coche	car (not "carro", "vehículo", "auto" or "automóvil")
la proteína	protein
temer	to fear
la oferta	offer (not "el ofrecimiento")
el puente	bridge
la facultad	faculty, ability (f...)
activo	active
la punta	tip, point, sharp end
la iniciativa	initiative
marchar	to march, leave
la banda	band
el vuelo	flight
el distrito	district (for admin. or law)
el motor	motor
Honduras	Honduras
rápidamente	quickly
el rayo	ray, lightning
el círculo	circle
amenazar	to menace, threaten
Sevilla	Seville
la silla	chair
la llegada	arrival
la liga	league
el contrato	contract
feliz	happy (f...)
el lago	lake
la reserva	reservation, reserve (not "la reservación")
el espectáculo	show
terrible	terrible
la sorpresa	surprise
la personalidad	personality
la belleza	beauty
el templo	temple (religious)
el discurso	discourse (speech)
huir	to run away, to escape, to flee (not escapar)
nervioso	nervous
fijo	fixed
combinar	to combine
notable	notable
la misión	mission
la referencia	reference
la instalación	installation
el plano	plan (street map, small scale); blueprint, drawing
golpear	to hit, to beat (up), to strike
el comportamiento	behavior, comportment
votar	to vote
permanente	permanent
la sede	headquarters (not "la central")
primario	primary
el mayor	adult (not adulto)
la categoría	category
atacar	to attack
operar	to operate
relativo	relative (comparative)
la lectura	lecture (reading)
la cocina	kitchen
la intervención	intervention
el gol	goal (score in sports) (not meta or tanto)
municipal	municipal
el parlamento	parliament
prohibir	to prohibit
efectuar	to carry out (e..); to make (payment, trip)
el dueño	owner (not propietario)
femenino	feminine
la mente	mind
el inicio	start, beginning (i..)
sugerir	to suggest (not proponer)
el comentario	commentary
enterar	to inform, tell, notify (not "informar")
el cuello	neck, collar
fabricar	to fabricate (to manufacture)
exacto	exact
la disposición	disposition
la deuda	debt
la onda	wave (hair, physics)
disminuir	to diminish
el consumo	consumption
quinto	fifth
disfrutar	to enjoy (not "gozar" or "divertirse")
el aparato	apparatus (machine)
revolucionario	revolutionary
apuntar	to point at, aim, to write down (not señalar)
el ave	bird (not pájaro)
devolver	to refund, to return
el indio	Indian (person)
significativo	significant (not "significante")
perfecto	perfect
el acceso	access
convocar	to convene, call together, summon
el relato	report (r..., not "el reporte"), story, account
la lima	lime (the citrus fruit)
la ausencia	absence
el daño	damage
la estrategia	strategy
Marte	Mars
normalmente	normally
gobernar	to govern (not regir)
universitario	(from) university
garantizar	to guarantee
el capitán	captain
atraer	to attract
opinar	to opine (to believe, to think)
pasado	past
particular	particular
el planeta	planet
el piano	piano
la alegría	happiness, joy (a...)
la chica	girl (c...)
el delito	crime (not too serious)
figurar	to appear, to be listed (f...)
la culpa	guilt, blame
la arena	sand
el novio	boyfriend
la interpretación	interpretation
otorgar	to award (o...)
breve	brief, short (not corto)
la longitud	longitude, length (not "largo")
bailar	to dance
cuándo	when
el cubano	Cuban (person)
la explicación	explanation
el contenido	content
corto	short, brief (not breve)
el temor	fear (t...)
la agricultura	agriculture
la danza	dance (not "el baile")
procedente de	proceeding from,  coming from (not "proveniente de")
inmediatamente	immediately, at once (not enseguida)
el hueso	bone
incrementar	to increase (not aumentar)
modificar	to modify
la discusión	discussion, argument
la exportación	exportation
el imposible	the impossible
despedir	to say goodbye; to fire/lay off (employee)
robar	to rob
registrar	to register
sesenta	sixty
la publicación	publication
médico	medical
experimentar	to experiment; to experience
administrativo	administrative
la academia	academy
el monte	mount, mountain (not "montaña")
evidente	evident
la encuesta	poll
característico	characteristic
el ingeniero	engineer
la nube	cloud
la perspectiva	perspective
inventar	to invent
la entrevista	interview
el dominicano	person from the Dominican Republic
la atmósfera	atmosphere (not "ambiente")
orientar	to orient, to guide, to direct
prometer	to promise
el coronel	colonel
constitucional	constitutional
genético	genetic
el cristal	crystal
auténtico	authentic
la moda	fashion
el jueves	Thursday
ingresar	to join, to enter, to deposit
la vieja	old woman
poner	to put (not colocar)
la columna	column
el ensayo	essay
absolutamente	absolutely
mezclar	to mix
contemporáneo	contemporary
la gestión	management
sumar	to sum, to add up to, to total
desempeñar	to carry out, to perform (d...)
el universo	universe
educativo	educational
doble	double
cultivar	to cultivate
el pájaro	bird (not "ave")
la guardia	guard (female)
impulsar	to boost, to propel
la tensión	tension
favorecer	to favor (not propiciar)
el arquitecto	architect
la riqueza	richness, wealth
el honor	honor
la manifestación	manifestation, demonstration (not "demostración")
acaso	perhaps (a...)
la dinastía	dynasty
la playa	beach
el lector	reader
el festival	festival
la galería	gallery
inmenso	immense
el invierno	winter
temprano	early
la leche	milk
el enfermo	sick person
arrancar	to tear off; to start up (a computer)
el particular	private individual
arreglar	to mend, to fix (not reparar); to arrange
constante	constant
la ruta	route
volar	to fly, disappear/vanish, blow away, fly by
la derecha	right (direction)
la conclusión	conclusion
el auto	car (not "vehículo", "coche", "carro", or "automóvil")
alzar	to lift, raise (a...) (not aumentar or asentar)
fiscal	fiscal
el secreto	secret
externo	external (not "exterior")
la derrota	defeat
descender	to descend
supremo	supreme
la esquina	corner (not "rincón")
la sección	section
Washington	Washington
el retrato	portrait
habitual	habitual
la excepción	exception
ampliar	to amplify
lejano	far, distant (l...) (not lejos)
la suma	sum
nuevamente	newly
practicar	to practice
soñar (con)	to dream (about)
lento	slow
la actuación	performance (of an actor)
hundir	to sink
fino	thin, fine (high quality)
el actor	actor
aclarar	to clarify
el productor	producer
gubernamental	governmental
el patrón	pattern
el nacimiento	birth
perfectamente	perfectly
interrumpir	to interrupt
la cola	tail, line, glue
derrotar	to defeat
invadir	to invade
la apertura	opening
la huelga	strike (work-stoppage, walk-out)
la inteligencia	intelligence
el pago	payment
el código	code (not "la clave")
tardar	to be late, to be slow, take (time)
la pasión	passion
inicial	initial
ceder	to yield, to give way, to give in
la distribución	distribution (not reparto)
la obligación	obligation
ligero	light, lightweight, slight (not leve or liviano)
diseñar	to design
brillante	bright, shiny, sparkling, brilliant
el alcalde	mayor
apartar	to move away, to separate (not separar)
creciente	growing
el socialista	socialist
peligroso	dangerous
el océano	ocean
la amistad	friendship
encabezar	to head
ajeno	alien (strange), foreign; someone else's (property); unconnected
el laboratorio	laboratory
la soledad	loneliness
la sesión	session
lindo	cute (not "mono" or "chulo")
el símbolo	symbol
infantil	infantile
el costo	cost (Lat Am) (not coste)
muchísimo	very much, a whole lot
percibir	to perceive
promover	to promote
gozar	to enjoy (not "disfrutar" or "divertirse")
denunciar	to denounce
la búsqueda	search (not "la busca")
el techo	ceiling, roof (generic)
el virus	virus
esencial	essential (not "imprescindible")
soportar	to bear, to endure, to put up with (not aguantar)
la península	peninsula
el experto	expert
la conquista	conquest
carecer	to lack (not faltar)
amarillo	yellow
la profesión	profession
la lágrima	tear (water from eye)
conquistar	to conquer (not vencer)
el accidente	accident
perseguir	to pursue
regalar	to give (as a present)
Israel	Israel
afuera	outside
la amenaza	threat
desconocido	unknown
el mexicano	Mexican (person)
marino	marine
peor	worse
prever	to anticipate (not anticipar)
facilitar	to facilitate
el zapato	shoe
liberal	liberal
el margen	margin
encerrar	to enclose
efectivamente	really, indeed (e...)
el azúcar	sugar
laboral	laboring
reclamar	to claim
la conducta	conduct
la corona	crown
la expansión	expansion
la avenida	avenue
el humo	smoke
el polvo	dust, powder
cargar	to load; to carry, to burden
la busca	search (not "la búsqueda")
el gato	cat
el reloj	clock
el miércoles	Wednesday
la molécula	molecule
dulce	sweet
la emoción	emotion, excitement
húmedo	humid, damp, moist
el salón	living room (not sala)
encender	to light; to ignite; to switch on; to arouse (not iluminar or alumbrar)
Egipto	Egypt
centrar	to center
once	eleven
el regreso	return; return journey (not "la vuelta")
quemar	to burn, incinerate; scorch (q)
finalizar	to finalize (not ultimar)
el traje	suit
el incremento	increment, increase (not alza or aumento)
el borde	border, edge (not frontera)
el rasgo	feature
la caída	fall, falling, tumble
el cliente	client
el canto	singing
la protesta	protest
el vaso	glass, vessel
calificar	to qualify; to grade; to rate
la compra	purchase
la profundidad	depth, profundity
regional	regional
la humanidad	humanity
el aeropuerto	airport
el impuesto	tax
continuo	continuous
la rueda	wheel (r...)
poderoso	powerful
derivar	to derive
violento	violent
Venezuela	Venezuela
el salario	salary (not sueldo)
localizar	to locate (not ubicar)
elaborar	to make, manufacture, produce
el muro	wall (m.. , not muralla)
organizado	organized
la catedral	cathedral
abarcar	to cover, to encompass, to span, to include (a...)
inclinar	to incline
el vacío	void, empty space
triste	sad
el caballero	gentleman; knight
la cuerda	cord, rope
la extensión	extension (not ampliación)
el filósofo	philosopher
estrecho	narrow, tight (not "apretado")
liberar	to liberate (not librar)
jurídico	legal (not "legal")
calcular	to calculate
el anciano	elderly person (not viejo)
frecuente	frequent
apreciar	to appreciate
Panamá	Panama
recientemente	recently (not recién)
fundamentalmente	fundamentally
cero	zero
condenar	to condemn
el castillo	castle
el sindicato	trade union, labor union (not "el gremio")
molestar	to bother, to upset
la observación	observation
la rosa	rose
previo	previous (not anterior)
originar	to originate
el reconocimiento	recognition
el italiano	Italian
verdaderamente	truly
el placer	pleasure (p...)
electrónico	electronic
el senador	senator
la pelota	ball (not bola or balón)
la hacienda	estate (h...)
la nariz	nose
la liberación	liberation
el toro	bull
confiar	to trust, to rely
saludar	to greet
desnudo	naked
deportivo	sports (relating to sports), casual, sportsmanlike
la corrupción	corruption
atreverse	to dare, to venture
la civilización	civilization
el testigo	witness
la vez	time, instance, turn
el equilibrio	balance (not balance)
el enemigo	enemy
el carro	car (Lat Am) (c.., not "el coche")
el cáncer	cancer
la bomba	bomb; pump
revisar	to revise (not "repasar"); to review
la palma	palm
el judío	jew
la jornada	working day (not "el día laborable")
concentrar	to concentrate
diario	daily (not cotidiano or diariamente)
el hilo	thread (to sew with)
transportar	to transport
ajá	aha
resistir	to resist
autónomo	autonomous
el corredor	runner, corridor
el estadio	stadium
la partida	game, departure
inferior	lower
alimentar	to feed
adentro	inside (not dentro)
el cura	priest (not sacerdote)
elevado	elevated
ocultar	to hide (not esconder)
renunciar	to renounce, quit (not dimitir)
la doctrina	doctrine
el enfrentamiento	confrontation (not "la confrontación")
confundir	to confound
la sierra	saw; mountain range
lavar	to wash
vacío	empty, void
la nave	ship (n...)
precioso	precious
prolongar	to prolong
especializado	specialized
la medida	measurement
sobrevivir	to survive
soltar	to release, to let go of, to drop
correcto	correct
agarrar	to grab
la coalición	coalition
la torre	tower
callarse	to shut up, to keep quiet, to remain silent
el automóvil	car (not carro, coche, or auto)
armado	armed
parlamentario	parliamentary
el loco	madman
ignorar	to be ignorant of, to not know (not desconocer)
el oído	ear (inner part), hearing (sense of)
designar	to designate
el fracaso	failure
el depósito	deposit
comparar	to compare
naturalmente	naturally
monetario	monetary
inspirar	to inspire
la resolución	resolution
el campeonato	championship
el argumento	argument, plot
terrestre	terrestrial
la fila	row, line (not línea or raya)
excelente	excellent
denominado	named, called (not "llamado")
regular	to regulate
equivocarse	to be mistaken; to be wrong (not "estar equivocado")
la fábrica	factory
la fruta	fruit
crítico	critical (very serious, crucial); critical (judgemental)
el tráfico	traffic
el tiro	throw, shot (not disparo)
la cumbre	summit (not cima)
el impacto	impact
el mando	command (m..), rule, leadership
la marca	mark
intelectual	intellectual
convenir	to agree, to suit (not acceder or acordar)
el mandato	mandate
negativo	negative
correspondiente	corresponding
la dimensión	dimension
expulsar	to expel
arrojar	to throw, to hurl (not echar, lanzar, or tirar)
limitado	limited
la pobreza	poverty
la oscuridad	darkness
la fórmula	formula
marcado	marked
el huevo	egg
firme	firm
el personal	staff
suave	soft (not “blando”), gentle
japonés	Japanese
espacial	relating to space
futuro	future
caliente	hot
magnífico	magnificent
el sujeto	subject (person in clinical trial); subject (grammar)
la virgen	virgin
la tienda	shop
existente	existing
ejecutar	to execute, perform
suspender	to suspend; to fail (an exam)
la instrucción	instruction
el incendio	fire (i.e. building burning) (not "el fuego")
el registro	registry
el ala	wing
el cabello	hair (not pelo)
el verso	verse
completar	to complete
empujar	to push
el príncipe	prince
el componente	component
evidentemente	evidently
la escalera	stairs (singular)
perdonar	to forgive, to pardon
el impulso	impulse
detectar	to detect
la dama	lady (d)
vincular	to link (not juntar)
la disciplina	discipline
la federación	federation
primitivo	primitive
pronunciar	to pronounce
divino	divine
fallecer	to die (not morir)
el señor	Mr., master, the Lord
secundario	secondary
la aventura	adventure
poético	poetic
la orilla	shore
el crimen	crime (very serious)
Cristo	Christ
el concurso	contest; tendering process [business]
besar	to kiss
Grecia	Greece
el sacerdote	priest (not cura)
extenso	extensive
extraer	to extract
la denuncia	denunciation, complaint
el carbono	carbon
conformar	to form (not "formar"), to make up; to create
segundo	second
limpio	clean
maravilloso	wonderful, marvelous
el fruto	fruit (the scientific term, not "la fruta"); fruit (result of labour); nut (edible)
traducir	to translate
el pantalón	trousers, pants (singular)
relativamente	relatively
procurar	to seek, try (procure)
la concentración	concentration
conectar	to connect
abrazar	to hug
el exterior	exterior
poblar	to populate
rural	rural
la villa	villa
el vestido	dress
reproducir	to reproduce
setenta	seventy
falso	false
descansar	to rest
el ángel	angel
dudar	to doubt
efectivo	effective
el máximo	maximum
múltiple	multiple
adelantar	to advance (ad...)
indígena	indigenous
material	material
lentamente	slowly (l...)
la pista de baile	dance floor
colgar	to hang; to hang up (the phone)
el empleado	employee
el entorno	surroundings (singular), environment (not "el ambiente")
la tela	fabric (not tejido)
formal	formal
confesar	to confess
el mapa	map
lucir	to shine (not brillar)
la oración	prayer, sentence
penetrar	to penetrate
la utilización	utilization, use (not uso or aplicación)
boliviano	Bolivian
el cantante	singer
Austria	Austria
la facilidad	facility, ease, aptitude
de repente	suddenly (d.., not "de pronto" or "de súbito")
la ilusión	illusion; hope; excitement (Sp.)
el humor	mood
el víctor	victor
la mezcla	mixture, combination, blend
encantar	to enchant, like
inaugurar	to inaugurate
la tabla	wooden plank, board (t.., not "el tablón"); table (graphic representation)
Alejandro	Alexander
Canadá	Canada
pasear	to go for a walk (not caminar or andar)
ochenta	eighty
la intensidad	intensity
la computadora	computer (not ordenador)
la virtud	virtue
el oficio	trade, job
sólido	solid
la variación	variation
proclamar	to proclaim
ascender	to ascend (not "subir")
emprender	to undertake, to begin
el establecimiento	establishment
la concepción	conception
colombiano	Colombian
negociar	to negotiate
la misa	mass (religious)
habitar	to live in, to inhabit (not residir)
izquierda	left
la mancha	spot, stain
semejante	similar (not similar or parecido)
rendir	to perform well
respirar	to breathe
el alcance	reach, range
acumular	to accumulate
tremendo	tremendous
el acero	steel
asomar	to show up, stick out, poke out
el comandante	commander
la cárcel	jail
distribuir	to distribute (not repartir)
desplazar	to displace
el rincón	corner, nook (not esquina)
la imaginación	imagination
la reducción	reduction
el significado	meaning
pesado	heavy
orgánico	organic
global	global
la radiación	radiation
el desierto	desert
conversar	to converse, to talk (not dialogar, hablar, or platicar)
sagrado	sacred
limpiar	to clean
acceder	to agree, to access (not acordar or convenir)
el campeón	champion
la continuación	continuation
la llanura	prairie
metálico	metallic
la postura	posture
perdido	lost
eficaz	efficient (not eficiente)
apretar	to press (not presionar)
juzgar	to judge
Ana	Anna
Castilla	Castile
fumar	to smoke
sucio	dirty
el perdón	forgiveness
pintado	painted
la ceremonia	ceremony
disparar	to shoot, to fire (not tirar)
la tumba	grave
la llave	key (for a lock); tap; switch; wrench
dentro	inside (not adentro)
el especialista	specialist
criticar	to criticize
Isabel	Elizabeth
Jaime	James
Ernesto	Ernest
el combate	combat
el capítulo	chapter
circular	to circulate
grueso	thick (size) (g..)
justificar	to justify
la consulta	consultation
el combustible	fuel
el aceite	oil
la combinación	combination
la clave	code, key (not código or llave)
la camisa	shirt
cansado	tired
la escritura	writing (not "la redacción")
la posesión	possession
la presentación	presentation
la identidad	identity
definitivamente	definitely
combatir	to combat, to fight (not luchar or pelear)
la botella	bottle
asesinar	to murder
increíble	incredible
la secretaría	secretary's office
la rodilla	knee
ancho	broad, wide, capacious (not amplio)
la cooperación	cooperation
el conservador	conservative
colonial	colonial
precisar	to specify (not "especificar")
el seno	bosom, breast
alterar	to alter
el progreso	progress
el plato	dish, plate
medieval	medieval
vital	vital
invertir	to invest; to invert, to reverse
la gloria	glory
Gonzalo	Gonzalo
la patria	homeland
solar	solar
el vapor	vapor
la preparación	preparation
la inflación	inflation
la antigüedad	seniority (in a job); antiquity; antique
considerable	considerable
la capitalización	capitalization (finance)
el esposo	husband (not marido)
consultar	to consult
el creador	creator
Díaz	Diaz
animar	to animate, to encourage
el obispo	bishop
la opción	option, choice
la angustia	anguish
clasificar	to classify
dotar	to gift, to provide (not dar, proporcionar or regalar)
escoger	to choose (not elegir)
el palo	stick
Horacio	Horace
enamorar	to win the heart
delgado	slim, slender, lean
la cuenca	basin, socket
doler	to hurt (d.., not "dañar")
el paseo	walk (stroll)
proyectar	to project
el rival	rival
el narcotráfico	drug trafficking
mental	mental
el receptor	recipient (r.., not "el recipiente"); catcher (baseball); receptor (biol.)
acostar	to put to bed
tropical	tropical
listo	clever, ready
la garantía	guarantee
alegre	happy (a...)
el cerro	hill (not colina)
el bolsillo	pocket
maestro	master, main
la grabación	recording
la curiosidad	curiosity
gastar	to spend (money)
colaborar	to collaborate
afectado	affected
apagar	to turn off
situado	situated
la recuperación	recuperation, recovery (not recobro)
latinoamericano	Latin American
el escándalo	scandal
Diego	Diego
acariciar	to caress
la alternativa	alternative
el ballet	ballet
la proporción	proportion
la pata	paw
Colón	Columbus
el cadáver	cadaver
el vicepresidente	vice president
el cristiano	Christian
la creencia	belief
titular	to title, call
compuesto	composed
la presa	prey
el golfo	gulf
la colaboración	collaboration
cotidiano	daily (not diario or diariamente)
evolucionar	to evolve
Nicolás	Nicholas
la clasificación	classification
el carbón	coal
el espectador	spectator
el defensor	defender
la reflexión	reflection (deep thinking) (not reflejo)
la vela	candle
jurar	to swear (e.g. in court); to vow
el hielo	ice
dictar	to dictate
el entusiasmo	enthusiasm
el asesinato	murder
abundante	abundant
delicado	delicate
respectivo	respective
recurrir	to turn to, appeal to
adaptar	to adapt
aislado	isolated
doméstico	domestic
el funcionamiento	operation (functioning)
judío	jewish
el montón	heap, pile
romántico	romantic
concebir	to conceive
cargado	loaded
la fortuna	fortune (not ventura)
eterno	eternal
el ejemplar	copy (e.g. of a book) (e...)
la claridad	clarity
claramente	clearly
el salto	jump, bounce
el taller	workshop, garage
la infancia	childhood (i)
el testimonio	testimony
el turismo	tourism
repartir	to distribute (not distribuir)
el camión	truck
el culto	culto; devotion, worship
el fiscal	prosecutor
probable	probable
el técnico	technician
estallar	to explode (not explotar)
el bronce	bronze
académico	academic
agradecer	to thank, be grateful for, appreciate
agudo	acute
el ayuntamiento	city hall; city government
el prado	meadow
padecer (de)	to suffer from
admirar	to admire
consumir	to consume
el coro	choir
la cita	appointment, date (with somebody)
la cinta	tape, ribbon
el cigarrillo	cigarette (not cigarro)
brindar	to drink a toast (to)
asiático	asian
la fibra	fiber
la tragedia	tragedy
transcurrir	to pass (time; not pasar)
el experimento	experiment
aguantar	to bear, to endure (not soportar)
el rumbo	course (direction, progress) (r..)
justamente	exactly, just (not exactamente)
el anuncio	advertisement, announcement (not comunicado)
la caña	small beer (Sp.); cane, reed; (fishing) rod
curioso	curious
fresco	cool, fresh
el episodio	episode
la importación	importation
productivo	productive
presidir	to preside
teatral	theatrical
respectivamente	respectively
masculino	masculine
comprometer	to compromise
agotar	to use up, exhaust, wear down
el familiar	relative (f...)
depositar	to deposit
la mina	mine (eg a coal mine), mine (field)
la invasión	invasion
el ordenador	computer (not computadora)
la leyenda	legend
el relieve	relief, prominence, terrain
la definición	definition
el electrón	electron
el físico	physicist, physique
estimular	to stimulate
bancario	bank, banking
policial	police
ligar	to tie, to bind (not atar)
el primo	cousin
recomendar	to recommend
aparte	apart, aside
el fragmento	fragment
difundir	to diffuse, to spread out, to broadcast
desconocer	to be ignorant of (not ignorar), to not know
el esquema	sketch; outline (e..)
el bloque	block, building brick, chunk of material
el maíz	corn
charlar	to chat
el menor	minor
la oreja	ear (exterior)
el protagonista	protagonist
artificial	artificial
la tesis	thesis
el titular	title holder, headline
Guillermo	William
la explotación	exploitation
oler	to smell
herido	injured (h..)
espiritual	spiritual
la bola	ball (not pelota or balón)
secreto	secret
la monarquía	monarchy
el misterio	mystery
el nieto	grandson
el prestigio	prestige
posiblemente	possibly
la transformación	transformation
la tonelada	ton
el preso	prisoner (not prisionero)
provenir	to come from
Roberto	Robert
el héroe	hero
la instancia	request (i..)
el líquido	liquid
la entrega	delivery
el ferrocarril	railway, railroad, train
colectivo	collective
la madrugada	dawn (not alba, amanecer, or aurora)
el patrimonio	heritage, patrimony; wealth, estate
el pez	fish living, not food
el propietario	owner (not dueño)
aspirar	to inhale, to vacuum, to aspire (to)
el exceso	excess
filosófico	philosophical
Ortega	Ortega
el latín	latin
inclusive	inclusive
armar	to arm
cálido	warm (not "caluroso")
el caribe	caribbean
africano	african
enterrar	to bury
reaccionar	to react
la selva	jungle (not "la jungla")
Tomás	Thomas
islámico	islamic
el mito	myth
sacudir	to shake, to beat, to dust (not agitar)
potencial	potential
la tarjeta	card
Mozart	Mozart
muerto	dead
imposible	impossible
imperial	imperial
etc	etc
Portugal	Portugal
pelear	to fight, to quarrel (not combatir or luchar)
Paraguay	Paraguay
magnético	magnetic
mejor	better
el gris	grey
reemplazar	to replace (not reponer)
agitar	to shake, to agitate (not sacudir)
el asiento	seat
absorber	to absorb
Berlín	Berlin
quejarse	to complain
temblar	to shake, to tremble (not estremecer)
subrayar	to underline
el insecto	insect
el gobernante	leader (not dirigente, líder, or mandatario)
la mentira	lie
la ola	wave (in water)
el obrero	worker (not trabajador)
el sureste	southeast
la evidencia	evidence
la feria	fair, festival (not el festival)
explotar	to exploit, to explode (not estallar)
el contexto	context
dibujar	to draw
formular	to formulate
el seguidor	follower
agradable	nice (not simpático)
el adulto	adult (not mayor)
el castellano	Castilian
excepto	except
consciente	conscious
el renacimiento	renaissance
radical	radical
la placa	plaque, shield, shingle, plate
la herencia	inheritance
la inquietud	worry (i..)
indio	indian
la tristeza	sadness
la caza	hunt
el beso	kiss
el ganador	winner
la estabilidad	stability
Fidel	Fidel
anotar	to make a note of
el promedio	average
calentar	to heat
la emisión	emission
el turno	turn, shift (not giro or vuelta)
débil	weak, faint, dim
lingüístico	linguistic
llover	to rain
el tabaco	tobacco
avanzado	advanced
franco	Frank (heritage)
la satisfacción	satisfaction
tecnológico	technological
viena	vienna
el porcentaje	percentage
el milagro	miracle
la hembra	female
el conductor	driver
Francisco	Francis
decisivo	decisive
violar	to violate
el ecuador	equator; halfway point, midway
la fabricación	manufacture (not elaboración)
el historiador	historian
nativo	native (not "natal" or "indígena"), local, indigenous
la ocupación	occupation
la legislación	legislation
la prisión	prison (not cárcel)
la convención	convention
chileno	chilean
anoche	last night
la primavera	spring (season)
la transmisión	transmission
la tribu	tribe
la meta	goal, objective, aim, finish line (not gol or tanto)
el herido	injured person, wounded person
el crítico	critic
cesar	to cease
el pacto	pact
sindical	trade union (Adj.)
el gabinete	office (g...); cabinet (in government)
el deber	duty
diplomático	diplomatic
absurdo	absurd
pacífico	peaceful (p..)
penal	criminal (Adj.) (not "criminal")
el reinado	reign
el local	premises (not "el recinto")
la consideración	consideration
la felicidad	happiness (f..)
el monumento	monument
el pedazo	piece, chunk, morsel (not trozo or pieza)
rosa	pink (not "rosado")
sano	healthy
sonoro	resounding, loud, resonant
el mueble	piece of furniture
el consenso	consensus
el cariño	affection, darling, honey (c...)
la guía	guide(book); guide (woman)
el suceso	incident, event (s...)
la secuencia	sequence
el regalo	gift, present (not "el obsequio")
montañoso	mountainous
el consumidor	consumer
la vocación	vocation
brillar	to shine (not lucir)
ambiental	environmental (not "medioambiental")
el muerto	dead person
el homenaje	tribute (not "el tributo")
el horizonte	horizon
la semilla	seed
ratificar	to ratify
la banca	bank, banking
desprender	to detach, dislodge
el paquete	package
secar	to dry
la pensión	pension
Valencia	Valencia
el permiso	permission
práctico	practical
el satélite	satellite
el decreto	decree
el cuidado	care, attention (c..)
biológico	biological
el socio	member (not "el miembro"), partner, associate
el vaquero	cowboy
el mineral	mineral
el sombrero	hat
la conservación	conservation
la cerámica	ceramic
castigar	to punish
digno	honorable, worthy, dignified, (d...)
Julia	Julia
el visitante	visitor
el verbo	verb
Oscar	Oscar
el pasaje	passage; ticket
delante	ahead (location)
la alteración	alteration
la cerveza	beer
institucional	institutional
la humedad	humidity
la libra	pound
la seda	silk
republicano	republican
renovar	to renovate
el desastre	disaster
el dormitorio	bedroom
el coste	cost (Sp.) (not costo)
exhibir	to exhibit (not exponer)
el alcohol	alcohol
el panorama	view (not "la vista")
el rumor	rumor
el sucesor	successor
la habilidad	ability
telefónico	telephone
nocturno	night, nocturnal
preocupado	worried (not inquieto)
el embajador	ambassador
exclusivamente	exclusively
la maquinaria	machinery
el lujo	luxury
la destrucción	destruction
la localidad	location, place (not localización or ubicación)
seleccionar	to select
silencioso	silent, quiet, still (s..)
obrero	working (o..)
la difusión	diffusion
el flujo	flow
complicar	to complicate
la vacación	holiday, vacation
la totalidad	totality, whole
favorable	favorable
la dependencia	dependence
igualmente	likewise, equally
juntar	to put together, join, collect
la infección	infection
redondo	rounded
la expedición	expedition
el cálculo	calculation
abordar	to board
el pico	peak, beak
la integración	integration
el orgullo	pride
el sacrificio	sacrifice
geográfico	geographic
la contaminación	contamination
el tubo	tube
el yacimiento	deposit (mineral)
contratar	to hire, to contract (professional services)
el evento	event (e...)
el chino	Chinese (person; language); person of mixed race (Lat Am)
imprimir	to print
gordo	fat
Marcos	Mark
palestino	Palestinian
el arroz	rice
la estancia	stay (e.g., enjoy your stay) (not "la estadía")
dorado	gold, golden (color)
la criatura	creature
fallar	to fail (not fracasar)
extremo	extreme
operativo	operative
el té	tea
residir	to reside
la explosión	explosion (not estallido)
la fantasía	fantasy
Australia	Australia
la comedia	comedy
conjunto	joint
el rojo	the color red (not "el colorado")
la separación	separation
barato	cheap, cheaply, trashy
espectacular	spectacular
la acusación	accusation
el circuito	circuit
el cobre	copper
la pesca	fishing, catch
el trono	throne
generalizar	to generalize
el examen	exam
bravo	brave (not "valiente"); fierce; angry (Lat Am)
asociar	to associate
la aprobación	approval
particularmente	particularly
tuyo	yours (informal, singular)
el planteamiento	approach (p...), viewpoint; explanation; proposal
la celebración	celebration
divertir	to amuse, to entertain (not entretener)
la modificación	modification
ilegal	illegal
el ideal	ideal
preparado	prepared, ready (not listo)
la transición	transition
visible	visible
el perfil	profile
la bandera	flag
atrapar	to trap
la soberanía	sovereignty
la precisión	precision
murmurar	to murmur
la apariencia	appearance (how something looks)
el despacho	office (d...)
decorar	to decorate
el trato	treatment (not tratamiento)
borrar	to erase
la peña	rock (p...)
la realización	realization (fulfillment)
el sargento	sergeant
el mago	magician
la copia	copy (c...)
el eco	echo
la huella	footprint, track
el talento	talent
la promesa	promise
el reglamento	rules (singular) (not "regla")
la granada	pomegranate
disputar	to dispute
excesivo	excessive
el aliado	ally
valioso	valuable
el alto	the high one; stop sign (Mex.)
capturar	to capture (not captar)
el colega	colleague (not compañero)
el mediodía	midday
rezar	to pray (r.., not "rogar")
consolidar	to consolidate
la geografía	geography
la electricidad	electricity
asignar	to assign
el sabor	taste (not gusto)
representativo	representative
el logro	achievement
masivo	massive
musulmán	Muslim
el reto	challenge (r...)
el pasillo	hallway, corridor (p...)
la pantalla	screen, monitor
la herramienta	tool
anteriormente	previously (not previamente)
la fama	fame
engañar	to cheat, deceive
el aprendizaje	learning; apprenticeship
meridional	southern (not "sureño")
el liceo	high school (l..), secondary school
Picaso	Picasso
el síntoma	symptom
la bahía	bay (body of water)
el compuesto	compound
incapaz	incapable
el intercambio	exchange
la votación	voting
la guitarra	guitar
el rechazo	rejection
reducido	reduced
profundamente	profoundly, deeply
el amante	lover
adivinar	to guess
el calendario	calendar; schedule
beneficiar	to benefit
el diablo	devil
el repertorio	repertoire
la señorita	miss, young lady
el guerrero	warrior
valorar	to value
el terror	terror
la multitud	crowd (not "la muchedumbre")
Alicia	Alice
el exilio	exile
el oxígeno	oxygen
el mundial	world championship
el parecer	opinion (not opinión)
la restauración	restoration
la garganta	throat (not neck)
la desgracia	misfortune (not "la desventura")
culminar	to culminate
datar	to date (to put a date on, to date back to/from)
contento	happy (c...)
examinar	to examine
el estómago	stomach (e..)
el monarca	monarch
misterioso	mysterious
la vergüenza	embarrassment
hondureño	honduran
la hipótesis	hypothesis
prender	to catch (apprehend); to light, to turn on
lamentar	to regret
la fiebre	fever (not "la calentura")
el drama	drama
la pluma	feather, pen
el sillón	armchair (not "silla" or "butaca")
sucesivo	successive
la esencia	essence
el tronco	trunk, log
la aportación	contribution (not aporte or contribución)
conforme	satisfied (not "satisfecho")
pálido	pale
involucrar	to involve
el opositor	opponent (not "el oponente")
competir	to compete
el déficit	deficit
el vientre	belly (v..), stomach, abdomen
definido	defined
el castigo	punishment
asustar	to frighten, to scare (not espantar)
obedecer	to obey
el macho	male (m...)
mecánico	mechanical
el mandatario	leader, head of state (not dirigente, gobernante, or líder)
Hugo	Hugo
severo	severe
motivar	to motivate
asociado	associate, associated
el conde	count (nobleman), earl
estrenar	to use for the first time, to premiere
el fundador	founder
paralelo	parallel
noventa	ninety
fantástico	fantastic
el agujero	hole (not "el hueco" or "el hoyo")
agrario	agricultural, agrarian (not agrícola)
cuadrado	square, checkered
el contraste	contrast
elemental	elementary
adicional	additional
hola	hello
je	he
la ingeniería	engineering
el privilegio	privilege
Polonia	Poland
reiterar	to reiterate
nacionalista	nationalist
el niño	child (boy)
mágico	magical
el indígena	native (person) (i..)
suelto	loose (not "flojo"), free, flyaway (not libre)
la cordillera	mountain range (not sierra)
financiar	to finance
la fusión	fusion
la autonomía	autonomy
el superior	superior
la síntesis	synthesis
la sinfonía	symphony
el pasajero	passenger
el cierre	closing, shutting (not clausura)
chico	small (c...)
el recorrido	journey, trip (not trayecto or viaje); tour
la trayectoria	trajectory
vecino	neighboring
el tesoro	treasure
pisar	to step on (not caminar)
peruano	peruvian
disolver	to dissolve
corriente	common (...e)
el varón	male (v...)
acoger	to take in
descartar	to discard
la dieta	diet
el costado	side (not "el lado" or "la vera")
la estadística	statistic
estricto	strict (e)
la sensibilidad	sensitivity
solucionar	to solve (not resolver)
el legislador	legislator
captar	to capture (not capturar)
el ruso	Russian (person)
la prosa	prose
la locura	madness
el complejo	complex
el aficionado	fan, admirer, enthusiast, amateur
temporal	temporary (not "temporario")
la tranquilidad	peacefulness, tranquility
aparentemente	apparently (a.., not "al parecer")
arquitectónico	architectural
la circulación	circulation
fortalecer	to strengthen, to fortify
corregir	to correct
lógico	logical
protestar	to protest
naval	naval
la editorial	publishing house, publishing company
abstraer	to abstract
el turista	tourist
la traducción	translation
adiós	goodbye
el bienestar	well-being
el desempleo	unemployment (not "el paro")
la novedad	innovation, novelty (not innovación)
el rendimiento	rendition, performance (not actuación)
dominicano	dominican
la boda	wedding
el anillo	ring
el tanto	point, goal, certain amount (not gol or meta)
la bacteria	bacteria, germ
la concesión	concession
contenido	self-controlled, restrained
el romano	Roman (person)
plano	flat, plane (not llano)
el jurado	jury
la densidad	density
el canciller	chancellor
la cartera	wallet (not "la billetera")
la comparación	comparison
clavar	to hammer
fácilmente	easily
la petición	request (p..)
la publicidad	advertising, publicity
el préstamo	loan
el intérprete	interpreter
imitar	to imitate
Elena	Helen
la depresión	depression
la exigencia	demand (not demanda)
fracasar	to fail (not fallar)
estético	aesthetic
la especialidad	specialty
la audiencia	audience (not auditorio)
el grano	grain
Irlanda	Ireland
olímpico	olympic
el vendedor	vendor, salesman, stallholder
oculto	hidden (not escondido)
el gerente	manager (not directivo)
bañar	to bathe
la barrera	barrier
ideal	ideal
infinito	infinite
Pablo	Paul
sumamente	extremely (not extremadamente)
la sentencia	sentence (legal, not "la condena"), ruling, maxim
sensible	sensitive
el sueldo	salary (not salario)
la rebelión	rebellion
la orientación	orientation
impresionante	impressive, amazing (not "imponente")
luminoso	luminous
flotar	to float
forestal	forested, foresteal
la emergencia	emergency
la cosecha	harvest
diferenciar	to differentiate
la guerrilla	guerrilla force
el usuario	user
integrante	integral, integrating
multiplicar	to multiply
el sudor	sweat
la polémica	polemic, controversy
el realismo	realism
la melodía	melody
el asesor	advisor
el uniforme	uniform
trece	thirteen
la afirmación	affirmation
la candidatura	candidacy, candidature
mero	mere
Jorge	George
proseguir	to prosecute, to pursue, to continue (p...)
el pendiente	pendant, earring, unresolved matter
la sucesión	succession
solitario	solitary
agrupar	to group
la asistencia	assistance
fluir	to flow
la vanguardia	vanguard, the avant-garde
ahorita	right now (not "ahora mismo"); any minute now
administrar	to administer
Ruiz	Ruiz
la promoción	promotion
la matemática	mathematics (singular form)
el clásico	classic
la descripción	description
el corto	a short person or thing
criar	to raise, to breed (animals)
la dignidad	dignity
la fachada	facade
acomodar	to accommodate; to seat; to put; to adapt (not adaptar)
el fantasma	ghost
el enfoque	focus (not "el foco"), approach
la limitación	limitation
responsable	responsible
veinticinco	twenty-five
el convenio	agreement (c..)
la desaparición	disappearance
asentar	to settle down
la conexión	connection
la broma	joke (not chiste)
el cable	wire (not "el alambre")
la solidaridad	solidarity
sobrar	to be left over, to remain
la rapidez	speed, rapidity
el esclavo	slave
ultimar	to finalize (not finalizar)
escolar	school, scholastic
reforzar	to reinforce
la miseria	misery
el mantenimiento	maintenance
el griego	Greek (person, language)
el emisor	transmitter (radio/TV, not "el transmisor" or "la emisora"); issuer (finance); spokesperson
la comprensión	understanding, comprehension (not "el entendimiento")
territorial	territorial
el trozo	piece, fragment, section (t...)
dominante	dominant
regir	to govern, to rule (not gobernar)
el reflejo	reflection (image) (not reflexión)
la gravedad	gravity (physical force); gravity (seriousness)
la gota	drop
estable	stable
la armonía	harmony
la tormenta	storm
excepcional	exceptional
el plomo	lead (element)
impresionar	to impress
la convocatoria	notification (not "la notificación"); summons (legal)
la vegetación	vegetation
la violación	violation
vigilar	to watch over (not velar)
la dictadura	dictatorship
la biblia	bible
la interacción	interaction
el odio	hate, hatred
remoto	remote, distant (r...)
brasileño	Brazilian
la cena	dinner
la duración	duration
frenar	to brake (to slow down, to stop)
la estatua	statue
la estimación	estimation
el buque	ship, vessel, boat (b... not barco)
el bailarín	dancer
Teresa	Theresa
turístico	tourist (Adj.)
la mejilla	cheek
el archivo	file, archive; filing cabinet
elegante	elegant
el derivado	derivative
costero	coastal
la lesión	injury (not "la herida")
optar	to opt
la joya	jewel, piece of jewelry
el dispositivo	device, mechanism (not mecanismo)
desesperado	desperate
estructural	structural
la barba	beard
el comerciante	dealer, storekeeper, merchant
el almacén	warehouse
la eficacia	efficiency (not "la eficiencia"), effectiveness, efficacy
el músculo	muscle
la maravilla	wonder
la reproducción	reproduction
la respiración	breathing
el rosario	rosary
el plástico	plastic
la muñeca	doll, wrist
el japonés	the Japanese language
la crónica	chronicle, report (not informe, reporte, noticia or reportaje)
el defecto	defect, flaw
continental	continental
el descanso	rest, relaxation
la proyección	projection
sospechar	to suspect
el tercio	the third (fraction)
Sebastián	Sebastian
la hierba	grass, herb
odiar	to hate
la precipitación	precipitation, rain, rush
estratégico	strategic
contigo	with you (informal, singular)
la decoración	decoration
el violín	violin
el argentino	Argentinian (person)
Sofía	Sophia
la grasa	fat
Raúl	Raul
el colaborador	collaborator
la convicción	conviction (re. belief)
costarricense	Costa Rican
la ruina	ruin
la lógica	logic
marítimo	maritime
Mendoza	Mendoza
el pariente	relative (p...)
el entrenador	coach (of an athletic team)
la expectativa	expectation
el casco	helmet
el antecedente	antecedent, precedent
acelerar	to accelerate
clínico	clinical
la ejecución	execution
la embajada	embassy
personalmente	personally
la prisa	hurry
el requisito	requisite, requirement
el algodón	cotton
la vaca	cow
la confederación	confederation
dieciocho	eighteen
Alfredo	Alfred
la rabia	anger, rage (r..); rabies
la lección	lesson
juvenil	young (not joven)
la media	average, stocking, tights (Noun) (not "el promedio")
el llanto	crying (not "el lloro")
Napoleón	Napoleon
Ramírez	Ramirez
el pozo	well, shaft
oscilar	to swing, fluctuate
Suecia	Sweden
el cuero	leather
exclamar	to exclaim
albergar	to house, to host
centroamericano	Central American
el obstáculo	obstacle
dirigente	leading, ruling
el genio	temper, genius
el musulmán	Muslim
la ronda	round
el fiel	the faithful one
deslizar	to slip, to slide (not "resbalar")
el centímetro	centimeter
complicado	complicated
la cortina	curtain
el respaldo	back (of a chair, e.g.)
el revés	reverse, setback
el recinto	enclosure, grounds, premises (not "el local")
la plataforma	platform (p..)
platicar	to talk, chat, tell (Lat Am) (p..)
el rango	rank, standing, status
programar	to schedule, to program, to plan
el cuchillo	knife
el comedor	dining room
el cartel	poster (not "el póster")
aquél	that one (over there) (masc. short)
el tránsito	transit, traffic (not tráfico)
el testamento	last will, testament
cuestionar	to question (cast doubt)
fomentar	to promote, to foment
chocar	to shock, crash, clash
picar	to sting, to bite  (by an insect)
la navegación	navigation
Gutiérrez	Gutierrez
el horror	horror
holandés	Dutch
el hábito	habit (not "la costumbre")
concretamente	concretely; specifically; exactly
la cancha	court (sports)
disponible	available
el duque	duke
detallar	to detail
la cualidad	quality (inherent characteristic)
forzar	to force
la hormona	hormone
el pulmón	lung
la subasta	auction
el sello	stamp (Sp.) (not "la estampilla")
el rito	rite, ritual
el hueco	hole (not "el agujero" or "el hoyo"), hollow
el manuscrito	manuscript
la calma	calm
colorado	red (not "rojo")
la adaptación	adaptation
Ricardo	Richard
el sobrino	nephew
molecular	molecular
capital	capital
el barro	mud (not "el lodo")
evaluar	to evaluate
la contribución	contribution (not aporte or aportación)
el culpable	guilty party, guilty, culprit (not "el responsable")
la máscara	mask (not careta)
sembrar	to sow, to plant, to scatter
retornar	to return (not devolver, volver or regresar)
psicológico	psychological
novecientos	nine hundred
oral	oral
la laguna	lagoon
Irak	Iraq
denso	dense
atribuir	to attribute
teórico	theoretical
la agenda	agenda; appointment book
el escudo	shield
el nervio	nerve
inmóvil	immobile, still
Escocia	Scotland
empresarial	entrepreneurial
el gallo	rooster
atómico	atomic
brotar	to sprout, to appear, to bud
la utilidad	utility
el afán	eagerness, zeal (not celo)
Cristina	Christina
la disputa	dispute
la infraestructura	infrastructure
el paro	strike (not huelga); unemployment (Sp.)
inteligente	intelligent
mentir	to lie, deceive
el escritorio	desk
la flota	fleet, crowd (Lat. Am.)
la cuota	quota, fee, share
el aliento	breath
la paloma	dove, pigeon
el piloto	pilot
seguir	to follow, to continue (s...)
Uruguay	Uruguay
provincial	provincial
amable	kind
la altitud	altitude
la barra	bar (of chocolate)
apostar	to bet
el brillo	brightness, shine (not resplandor)
caro	expensive
la corteza	crust, bark (of tree)
la desesperación	desperation
la esfera	sphere
el asentamiento	settlement
alegrar	to make happy
la paciencia	patience
sorprendente	surprising
rubio	blonde
el noroeste	northwest
el viajero	traveler
horrible	horrible
la solicitud	request, application (s..)
cómodo	comfortable
Gabriela	Gabriela
deshacer	to undo
la cría	baby animal, breeding
ja	ha
el almuerzo	lunch
ajustar	to adjust
avisar	to warn (not advertir)
el trigo	wheat
Alonso	Alonso
la ciudadanía	citizenship
doscientos	two hundred, 200
egipcio	egyptian
explorar	to explore
el estímulo	stimulus
la inspiración	inspiration
ojalá	hopefully, I hope; if only
maldecir	to curse
la sanción	sanction
el residente	resident
el supuesto	supposition, assumption (not asunción or suposición)
el horno	oven
la falda	skirt
el desorden	disorder (not "el trastorno" or "el desconcierto")
vigente	valid (not válido)
verbal	verbal
vasto	vast
tragar	to swallow
el fármaco	drug, medicine (f..)
el fresco	fresh air
el mamífero	mammal
petrolero	of or related to oil (e.g., oil company)
la marina	navy (not armada)
guiar	to guide
la lámpara	lamp
la galaxia	galaxy
la alimentación	food, diet (not alimento, comida or dieta)
la uña	fingernail, toenail
el acento	accent
atractivo	attractive
barroco	baroque
la elaboración	making, production (not fabricación or producción)
contraer	to contract (e.g. disease); to shrink, abbreviate
Arturo	Arthur
el medicamento	medicine, drug (not medicina, droga or farmaco)
anaranjado	orange; orange colored
la minoría	minority
necesariamente	necessarily
el otoño	autumn
Suárez	Suarez
el azul	blue color
Agustín	Augustine
feo	ugly
convencional	conventional
el arroyo	stream, brook (not rivera)
Bélgica	Belgium
Siria	Syria
presionar	to press (not apretar)
la nieve	snow
la magnitud	magnitude
el hidrógeno	hydrogen
el heredero	heir
el mínimo	minimum
presunto	presumed, supposed, alleged (not supuesto)
la sábana	bedsheet, sheet
rodar	to roll
Jiménez	Jimenez
el correo	mail
doloroso	painful
el descenso	descent
entrever	to glimpse, to catch sight of (not "vislumbrar")
el hallazgo	find
mediterráneo	Mediterranean
el suroeste	southwest
mediano	medium
la narración	narration
la lástima	pity, shame (l)
inevitable	inevitable
editar	to edit
conveniente	convenient
el balón	ball (not pelota or bola)
la capilla	chapel
la coca	coca  (cocaine plant)
la persecución	persecution
trazar	to trace
el pecado	sin
la renta	income, rent (not alquiler)
gigantesco	gigantic (not "gigante")
el giro	turn (not vuelta or turno)
el mérito	merit
el contemporáneo	contemporary
constantemente	constantly
la curva	curve
desviar	to divert
la fracción	fraction
la cintura	waist
la che	letter ch
el amanecer	dawn (not alba, aurora, or madrugada)
la hectárea	hectare
el prisionero	prisoner (not preso)
ideológico	ideological
la madurez	maturity
la aspiración	aspiration
el trastorno	disorder (not "desorden" or "el desconcierto")
el teniente	lieutenant
Tegucigalpa	Tegucigalpa
la ficción	fiction
el enfermero	nurse
el espectro	spectrum (not "la gama")
el diagnóstico	diagnosis
la debilidad	debility, weakness
Corea	Korea
la moral	moral (Noun), morals; morale
oficialmente	officially
el natural	nature (not naturaleza)
humilde	humble
el helado	ice cream
el intermedio	intermission
la invitación	invitation
rescatar	to rescue
el sida	AIDS
encendido	turned on (e.g., a light) (not "iluminado")
aguardar	to wait for, await, expect (not esperar)
el adolescente	adolescent, teenager
ciertamente	certainly (not seguramente)
el choque	crash, shock, conflict
el ahorro	saving
el norteamericano	North American (person)
rígido	rigid
la psicología	psychology
el paraíso	paradise
el condado	county
el comunista	comunist
la confusión	confusion
blando	soft (not "suave"), weak, lenient
anticipar	to anticipate, to advance (not avanzar)
la nobleza	nobility
ibérico	Iberian
el lanzamiento	launch, throwing
el kilo	kilogram (shorter form)
singular	singular
la ternura	tenderness, endearment
tomar	to take, to have (something to eat or to drink)
saber	to know (facts)
la lana	wool
aparente	apparent
la fortaleza	strength, fortress (not fuerza)
la cúpula	dome
castellano	Castilian
interesado	interested, selfish (not egoísta)
el túnel	tunnel
el islam	islam
el horario	schedule, timetable, hours
el remedio	remedy; medicine (Lat Am)
el calderón	large caldron
arqueológico	archaeological
la delegación	delegation
ejemplar	exemplary
el cementerio	cemetery
el celo	zeal (not afán)
la ideología	ideology
iluminar	to illuminate, to light (not alumbrar or encender)
el licenciado	graduate (l..)
el infierno	hell
suficientemente	sufficiently
el queso	cheese
Centroamérica	Central America
el discípulo	disciple
el desafío	challenge (not reto)
la tinta	ink
elaborado	elaborate
la captura	capture
básicamente	basically
el asalto	assault, holdup
la asunción	assumption, supposition (not suposición or supuesto)
la química	chemistry
resaltar	to highlight, to stand out (r...)
salvaje	savage
el polo	pole
el liberal	liberal
andino	Andean
la biología	biology
enseguida	immediately, at once (not inmediatamente)
el fotógrafo	photographer
la falla	flaw
catalán	Catalonian
el saco	sack, jacket
la evaluación	evaluation
educar	to educate; to bring up
el cristianismo	Christianity
culto	cultured, educated (not educado)
el cumplimiento	fulfillment
espeso	thick (liquids, forest) (e..)
enriquecer	to enrich
el abuso	abuse
inútil	useless
Laura	Laura
Enrique	Henry
vengar	to avenge
el vigor	vigor
el manifiesto	manifesto
la regulación	regulation
la renovación	renovation
el real	real (Brazil. currency); penny
el centenar	hundred (not cien or ciento)
la diversidad	diversity
el editor	editor (not redactor)
la exploración	exploration
cívico	civic
el ratón	mouse
la ofensiva	offensive, attack
la modalidad	modality
el vínculo	tie, link (not enlace)
el juguete	toy
Pakistán	Pakistan
retener	to retain
abandonado	abandoned
el comisario	commissioner, captain (not capitán)
demandar	to demand, to sue (not exigir or requerir)
el retorno	return (not vuelta or regreso)
heredar	to inherit
vertical	vertical
trágico	tragic
redactar	to write (not escribir); to edit
el sufrimiento	suffering
la clínica	clinic
el bolívar	bolivar (Venezuelan currency)
ahogar	to drown
la alfombra	carpet (not  "la moqueta" or "el tapete")
el americano	American (not gringo)
el administrador	administrator
el cemento	cement
la pausa	pause (not silencio or descanso)
la igualdad	equality
el hongo	fungus; mushroom, toadstool
el monasterio	monastery
el lecho	bed (of river/plants) (l..)
Hungría	Hungary
inaudible	inaudible
el globo	balloon, globe
suizo	Swiss
Sidney	Sidney
el seminario	seminary
desgraciadamente	unfortunately (not "desafortunadamente")
atento	attentive; courteous
apropiado	suitable, appropriate (a.., not "apto")
el escrito	document (not documento)
la revisión	revision
reinar	to reign
quebrar	to snap
el mármol	marble
gráfico	graphic
la percepción	perception
reconstruir	to reconstruct
el aroma	scent, aroma
la afición	hobby
el lazo	bow, knot, loop (not "el nudo")
la zarzuela	spanish operetta
la gobernación	government, governing (not "el gobierno")
mudo	mute
campesino	rural (c)
curar	to heal, to cure
la anécdota	anecdote
el residuo	remainder; residue
el redactor	editor (not editor)
planear	to plan (not planificar)
leve	slight; light (not ligero or liviano)
el lleno	sellout
interminable	interminable
el ladrillo	brick
lógicamente	logically
el olvido	oblivion; forgetfulness
remontar	to overcome (not superar); to go up
restaurar	to restore (not restablecer)
la adquisición	acquisition
la aceptación	acceptance
célebre	famous (c...)
el católico	catholic
la cubierta	cover
el delegado	delegate
el diccionario	dictionary
el economista	economist
las finanzas	finances
celebrado	celebrated
acentuar	to emphasize, to stress (a...)
el pastor	shepherd
propiciar	to favor (not favorecer)
posar	to pose, to place, to lay
la simpatía	friendliness
abundar	to abound
atlántico	atlantic
estirar	to stretch
exclusivo	exclusive
el cansancio	tiredness
preceder	to precede
ordinario	ordinary
triunfar	to triumph
morder	to bite
la mosca	fly
matemático	mathematical
horizontal	horizontal
la penumbra	half-light
septentrional	northern
relatar	to relate, tell [a story or a tale]
el activo	asset (financial)
la fauna	fauna
desplegar	to unfold, spread, unfurl
el abc	abc
argumentar	to argue (not discutir)
el cañón	cannon
la ceniza	ash (from burning)
inscribir	to inscribe
el ritual	ritual
la ruptura	break-up
el disparo	shot (not tiro)
válido	valid (not vigente)
la teología	theology
yugoslavia	yugoslavia
la determinación	determination
extrañar	to miss, to surprise (not sorprender)
cerebral	cerebral
la basura	garbage
el acorde	chord
el robo	robbery
Suiza	Switzerland
inducir	to induce
el liderazgo	leadership
monumental	monumental
el novelista	novelist
reponer	to replace (not reemplazar)
el perfume	perfume
álvarez	alvarez
el fallo	mistake (not "la equivocación"); ruling (legal)
el curioso	onlooker, bystander; busybody
damián	damian
el cajón	drawer
la inundación	flood
loco	crazy
el magistrado	judge (not juez); magistrate
marcelo	marcel
la mercancía	goods, merchandise
portar	to carry (not "llevar")
el oso	bear
la restricción	restriction
subterráneo	underground
sexto	sixth
alargarse	to get longer
aplastar	to crush, squash, swat (a...)
el foro	forum
el volcán	volcano
tapar	to cover, to cover up, to conceal (t..)
el tumor	tumor
la disolución	dissolution
arder	to burn, sting (a..)
el saludo	greeting; wave (with hand)
luisa	louisa
joder	to screw (sexual)
roto	broken
el sanitario	health worker
la pelea	fight (not lucha)
el cuartel	quarter (mil.), barracks
la fuga	escape (not "el escape")
templado	lukewarm (food), temperate (climate)
vuestro	your (v.., referring to singular object)
el asistente	assistant (not ayudante)
la popularidad	popularity
predominar	to predominate
el ramo	bunch, bouquet
reflexionar	to reflect (think)
almacenar	to store
el cubierto	piece of cutlery
el taxi	taxi
cruel	cruel
autorizar	to authorize
el aplauso	applause
sobresalir	to stand out (s..)
la rata	rat
núñez	nuñez
ligeramente	slightly (not "levemente")
realista	realistic
el restaurante	restaurant
el aporte	contribution (not aportación or contribución)
la contienda	argument, dispute; conflict, battle; (sporting) match [c...]
desagradable	unpleasant, disagreeable
el extraño	stranger (not desconocido)
el autobús	bus
la bóveda	vault; dome (ceiling)
el centavo	cent (not "el céntimo")
el chiste	joke (not broma)
restablecer	to restore (not restaurar); to reestablish
pescar	to fish
el trámite	procedure (not procedimiento)
urgente	urgent
tornar	to turn (to restore)
el noreste	northeast
indispensable	indispensable
beethoven	beethoven
la campana	bell (not timbre)
florecer	to flower
dramático	dramatic
Dinamarca	Denmark
espléndido	splendid
la certeza	certainty
el colombiano	Colombian (person)
la colina	hill (not cerro)
el aspirante	applicant
la mariposa	butterfly
relevante	outstanding, important; relevant (r...)
tibio	lukewarm, tepid
la vigilancia	surveillance
retroceder	to go back, to reverse, to back up
el fraude	fraud
Gabriel	Gabriel
experimental	experimental
el filo	blade, cutting edge
el deterioro	deterioration
la embarcación	boat, vessel (e...)
el delincuente	criminal (not "el criminal"); delinquent
agresivo	aggressive
el precedente	precedent
la meseta	plateau
térmico	thermal, thermic
la lata	can, tin (not bote)
potente	powerful, potent
simbólico	symbolic
adornar	to adorn
asombrar	to amaze, to astonish
diminuto	tiny (d..)
complementar	to complement
el rigor	rigor
portugués	Portuguese
quieto	quiet, still (q...)
el observador	observer
la urgencia	urgency
la nostalgia	nostalgia
inesperado	unexpected
rogar	to beg (not "suplicar"); to pray
sanguíneo	blood (Adj.); quick-tempered
la beca	scholarship
el balcón	balcony
el altar	altar
enfrente	in front; opposite, facing
dañar	to damage, harm, injure (d.., not "doler")
el corral	farmyard, yard
aludir	to allude to
la ansiedad	anxiety (not "el ansia")
la revelación	revelation
restringir	to restrict
la programación	programming; schedule, list of programs
afrontar	to face, to confront (a..)
tonto	stupid, silly
calmar	to calm
consagrar	to devote, consecrate
la docena	dozen
entusiasmar	to enthuse, to fill with enthusiasm; to excite
frecuentar	to frequent
la renuncia	resignation; abandonment, renunciation
Holanda	Holland
sistemático	systematic
sumergir	to submerge, plunge, immerse
desembocar	to flow into
el cuaderno	notebook (not "la libreta")
aconsejar	to advise
el ajuste	adjustment
el auditorio	auditorium, audience
equivaler	to be equivalent
Ignacio	Ignacio
la gira	tour, circuit
Julián	Julian
visual	visual
el tigre	tiger
variado	varied
turco	turkish
el milenio	millennium
la manzana	apple; city block
lorenzo	lorenzo
la prioridad	priority
el fósil	fossil
defensivo	defensive
directivo	directive; managerial
el analista	analyst
la ampliación	extension, expansion (not extensión)
la carcajada	laughter (not risa)
estupendo	great, stupendous
el puño	fist
sujetar	to hold, hold on to, hold down; to fasten
mercedes	mercedes
modesto	modest
la jugada	move, play, shot [in sports]; move [in chess]; a dirty trick, dirty play
irregular	irregular
el narrador	narrator
la limpieza	cleanliness
la serpiente	snake (not "la culebra")
sacrificar	to sacrifice
el pretexto	pretext
encaminar	to channel (not "canalizar"), to direct, to guide
la denominación	denomination, designation, name
la agrupación	grouping, arrangement into groups, clustering; ensemble; union
fatal	fatal; awful (familiar); fateful, unavoidable
la planificación	planning
respaldar	to endorse, to back
el socialismo	socialism
la terraza	terrace
la viuda	widow
restar	to subtract
la pesadilla	nightmare
ordenado	tidy, neat, orderly
legítimo	legitimate
la finca	farm (not granja)
la constante	constant
dialogar	to converse, to dialog (not conversar, hablar, or platicar)
aliviar	to relieve, to alleviate
cansar	to tire
el billete	ticket, bill, fare (not boleto or boleta); banknote
la bota	boot
la dosis	dose
narrar	to narrate, to tell, to relate
el ingenio	ingenuity, wit
pendiente	unresolved
quinientos	five hundred
salarial	salary (Adj.)
superficial	superficial
el transcurso	course (of time, progress) (t..)
vasco	basque
la propaganda	propaganda
la innovación	innovation
la lámina	sheet (of material) (not sábana)
gótico	gothic
mineral	mineral
el misil	missile
ecológico	ecologic
frustrar	to frustrate
generoso	generous
el enlace	link (not vínculo); hyperlink
la bebida	drink
el abrazo	hug
el atentado	attack (not ataque)
amargo	bitter
englobar	to encompass, to include, to comprehend, to comprise
la gallina	hen
la ecuación	equation
eficiente	efficient (not eficaz)
el directivo	manager (not gerente)
el militante	activist (not "el activista")
líquido	liquid
el guerrillero	guerrilla
el himno	hymn
el pañuelo	handkerchief
el tambor	drum
la trampa	trap; cheating
la represión	repression
el pianista	pianist
la ilustración	illustration
inicialmente	initially
la librería	bookstore
marta	martha
el diámetro	diameter
energético	energetic (not "enérgico"); energy (Adj.)
la enzima	enzyme
confuso	confused (not confundido)
callado	quiet, silent (c...)
el catálogo	catalog
averiguar	to find out (not "informarse" or "enterarse")
la divisa	currency (not "la moneda")
la mierda	shit
el juzgado	court [of law] (not corte or tribunal)
el refugio	refuge, shelter
el sustantivo	noun
transparente	transparent
samuel	samuel
sabio	wise
plenamente	fully, completely (not completamente)
el incidente	incident (not incidencia or suceso)
el mono	monkey
madrileño	of Madrid
despacio	slowly (d...)
desatar	to untie (not desligar); to trigger, unleash
la gama	range, scale, spectrum (not "el espectro")
el descendiente	descendant
el auxilio	help, assistance (not ayuda or asistencia)
la admiración	admiration
el bordo	side of a ship; tack (change in direction of ship)
noble	noble
hispano	hispanic
la variante	variant
el telescopio	telescope
la vertiente	slope, aspect (not aspecto) (v..)
ocasionar	to cause (not causar)
el lienzo	canvas (surface for an oil painting); painting
el cardenal	cardinal; bruise
claudia	claudia
y	and
la bala	bullet
el demonio	demon
emigrar	to emigrate
el escultor	sculptor
copiar	to copy
anular	to cancel (not "cancelar")
la cirugía	surgery (the subject not place)
la censura	censorship
paralizar	to paralyze
la proximidad	proximity
la talla	size (clothing or person's height, weight) (not "el tamaño" or "el talle")
suscitar	to give rise to
sujeto (a)	subject (to)
el retiro	retirement (not "la jubilación"); withdrawal; seclusion
el pabellón	pavilion, ward
imprescindible	essential (not "esencial")
librar	to free (not liberar)
reanudar	to resume
la sospecha	suspicion
la flora	flora
la facción	faction, feature
la continuidad	continuity
debilitar	to weaken
dieciséis	sixteen
el chiquillo	(small) kid
el compás	time measure (music); pair of compasses (drawing instr.); compass (navigation instr.)
sutil	subtle
mixto	mixed (not "mezclado")
el votante	voter (not elector)
inundar	to flood
la perfección	perfection
la condena	conviction 	(of a crime), sentence (not "la sentencia")
el azar	chance (a..), luck; random occurrence, coincidence
el fundamento	foundation (basis of a theory or belief)
excluir	to exclude
amoroso	loving (not "amador")
orgulloso	proud
el jazz	jazz
jose	joseph
gustavo	gustavo
glaciar	glacial (relating to glaciers)
la magia	magic
tejer	to weave
la transacción	transaction
hondo	deep (not profundo)
la proposición	proposal (not propuesta)
la recomendación	recommendation
clave	key (most important)
enfermo	sick
el encargo	assignment, order (made to)
distraer	to distract
burlar	to outwit, to trick
la puta	whore
parcial	partial
invisible	invisible
el porqué	reason (not razón)
suspirar	to sigh
el soporte	support (not apoyo)
el concilio	council
alentar	to encourage
el tenor	tenor
climático	climatic
creativo	creative
la franja	strip (of land); stripe; fringe
resistente	resistant
el pino	pine
la incertidumbre	uncertainty
el lobo	wolf
la membrana	membrane
navegar	to navigate, sail, cruise surf
fronterizo	border, bordering
el foco	focus (not "el enfoque")
devorar	to devour
el bloqueo	blockade
la agresión	aggression
el timbre	bell (not campana), doorbell
tropezar	to trip up, trip over, stumble
afortunadamente	fortunately
el balance	balance (not equilibrio)
el cráneo	skull
estudioso	studious
móvil	mobile
la licencia	license
el participante	participant
la prohibición	prohibition
vano	vain, conceited
la terapia	therapy
la vacuna	vaccine
protagonizar	to star (in)
protestante	protestant
el pescado	fish (to eat)
la salvación	salvation
la margarita	daisy
el matiz	nuance; hue, shade
el monje	monk
iluminado	lit, illuminated (not "encendido")
Juana	Joan
emocional	emotional
divertido	entertaining (not "entretenido")
diecisiete	seventeen
empeñar	to pawn; to give (one's word)
el arreglo	repair (not "la reparación")
el adjetivo	adjective
el circo	circus
conservador	conservative
el hidrocarburo	hydrocarbon
la migración	migration
el nido	nest
el revolucionario	revolutionary
el reparto	distribution (not distribución)
el periodismo	journalism
rodolfo	rudolf
el mozo	young boy/girl (m.., not "el muchacho"), waiter (S. Cone); mil. conscript (Sp.)
llano	flat, plain (not plano)
la confesión	confession
la ambición	ambition
la antena	antenna
el antepasado	ancestor (not "el ancestro")
asustado	frightened
la corporación	corporation
corporal	corporal, bodily
la ganancia	profit, gain
automático	automatic
anónimo	anonymous
aplaudir	to applaud
el agricultor	farmer (not granjero)
el afecto	affection (a.., not "la afección")
el abandono	abandonment;  desertion
cenar	to have dinner
celeste	celestial (not "celestial")
bautizar	to baptize
la miel	honey
restante	remaining
suministrar	to supply, to provide (not proporcionar or proveer)
compensar	to compensate
el trapo	cloth, rag
el cauce	riverbed; channel (c..)
el boliviano	Bolivian (person)
la atracción	attraction
el auge	boom (economically)
el expediente	file (e..), dossier, record
la eficiencia	efficiency (not "la eficacia")
el monseñor	monsignor
el pilar	pillar
la retirada	retreat
preservar	to preserve
metropolitano	metropolitan
la irregularidad	irregularity
el entrenamiento	training (coaching) (not capacitación)
la vena	vein
tradicionalmente	traditionally
el estreno	premiere
el esplendor	splendor
la decena	ten (units of ten)
oportuno	timely
la pretensión	pretension; aim, intention
provisional	provisional
el sendero	path (s.., not "la senda")
el suministro	supply
resumir	to summarize
el profeta	prophet
mortal	mortal
maya	mayan
la lente	lens
el gigante	giant
la escasez	scarcity, shortage
la furia	fury
bíblico	biblical
la competición	competition (not "el certamen"), contest
ausente	absent
distante	distant, remote (d...)
evocar	to evoke
la disminución	decrease
lírico	lyric
el protector	protector
el pescador	fisherman
la oveja	sheep
reventar	to burst
integral	comprehensive, complete (i...)
la erosión	erosion
exportar	to export
ferroviario	rail, railway, railroad (Adj.)
la decadencia	decadence
adulto	adult
la prenda	garment
la preferencia	preference
progresivo	progressive
sancionar	to sanction, to penalize
el hábitat	habitat
la medalla	medal
austriaco	Austrian
batir	to beat, whisk, whip
bizantino	Byzantine; pointless
entrevistar	to interview
la taza	cup; mug
la transferencia	transfer (not traslado)
enemigo	enemy
la finalidad	purpose (not propósito)
el cruce	crossing, crossroads, intersection
la casualidad	coincidence, chance (not coincidencia)
la llama	flame
la mutación	mutation
la ira	anger, rage (i..)
rematar	to conclude (not concluir)
la recepción	reception
suprimir	to suppress
simpático	nice (not agradable)
precipitar	to hasten, to precipitate
la partitura	score (musical)
el portero	doorman
la prima	bonus; female cousin
proveer	to provide, to supply, to fill (not proporcionar or suministrar)
pues	well (not bien)
la muralla	wall (of a city)
el asombro	astonishment
decorativo	decorative
la farmacia	pharmacy
transferir	to transfer (not trasladar)
el uranio	uranium
la diana	target (not "el blanco"); bull's-eye
el cerdo	pork, pig (not "el puerco")
el mosaico	mosaic
el invitado	guest
la intimidad	privacy (not "la privacidad"), private life; intimacy
independientemente	independently
la identificación	identification; ID card
indirecto	indirect
la queja	complaint
radiactivo	radioactive
pardo	brown, dark grey
el pasto	pasture
la piedad	mercy (not merced)
expresivo	expressive
ensayar	to rehearse
específicamente	specifically
la coordinación	coordination
el cazador	hunter
el cohete	rocket
conmover	to move (emotion)
ampliamente	amply, widely, easily
lamentable	regrettable
la  latitud	latitude
tardío	late (during an era); late in life; belated
implantar	to implant, to introduce
liso	smooth, even, straight
la pauta	guideline (not "la directriz"), rule, standard, pattern
cocinar	to cook, prepare meals
la dinámica	dynamics
el dramaturgo	playwright
el elector	voter (not votante)
emerger	to emerge
claudio	claudio
aburrir	to bore
el rancho	ranch
el pollo	chicken
el reclamo	claim, complaint, call
la rivera	brook (not arroyo)
el helicóptero	helicopter
indudablemente	undoubtedly
la reconstrucción	reconstruction
recto	straight
soplar	to blow
el original	original
la distinción	distinction
el terremoto	earthquake
voluntario	voluntary
el ciego	blind man
perjudicar	to damage (p..)
el inmigrante	immigrant
guerrero	warlike (not bélico)
la gramática	grammar
idéntico	identical
héctor	hector
herir	to wound
indiferente	indifferent
el levantamiento	uprising (not revuelta)
plantar	to plant
el grupo	group   (g..)
alegar	to allege
el encaje	lace
el encanto	charm
funcional	functional
flaco	skinny
el artesano	craftsman
el complemento	complement
la biografía	biography
el monopolio	monopoly
la monja	nun
el muslo	thigh
improvisar	to improvise
el cometa	comet
la arcilla	clay
aplicado	diligent (not diligente)
exquisito	exquisite, delicious
favorito	favorite
espontáneo	spontaneous
destrozar	to destroy (not destruir)
la controversia	controversy
la contradicción	contradiction
el turco	Turkish (language); Turk
el cromosoma	chromosome
insuficiente	insufficient
nadar	to swim
la pistola	gun
el químico	chemist, chemical
supuestamente	supposedly
rodrigo	rodrigo
el entendimiento	understanding (not "la comprensión")
el equivalente	equivalent
fundir	to melt
la aguja	needle
el acta	minutes (eg. of a meeting)
ciego	blind (person)
la carencia	lack (not falta)
la charla	chat
la complejidad	complexity
la concha	shell
el romanticismo	romanticism
polaco	Polish (nationality)
maduro	mature
el temblor	tremor, shaking; earthquake
el manto	cloak (not capa)
el instinto	instinct
Indonesia	Indonesia
perteneciente	belonging, pertaining
el ascenso	ascent (not subida)
el astrónomo	astronomer
frecuentemente	frequently
el dictador	dictator
el bando	faction (not la facción), side
adolfo	adolf
el budismo	buddhism
peculiar	peculiar
la rutina	routine
la redacción	writing (not "la escritura"), editing; editorial office/team; essay
la invención	invention
obviamente	obviously
la niebla	fog
mojado	wet
geométrico	geometric
el rebelde	rebel
prestigioso	prestigious
el amo	master (not maestro)
la cooperativa	cooperative
el desayuno	breakfast
flamenco	flamenco
fluvial	river
estrictamente	strictly
bélico	war, warlike (not guerrero)
el romance	romance
la siesta	nap
ilustrado	illustrated
injusto	unfair
prevenir	to prevent
paco	paco
el bebé	baby (not nene)
la correspondencia	correspondence
el vídeo	video (Sp.)
expandir	to expand
cazar	to hunt
el atleta	athlete
simultáneamente	simultaneously
el inconveniente	drawback, disadvantage, problem (not desventaja or problema)
el nudo	knot (not "el lazo")
obligatorio	compulsory
el hemisferio	hemisphere
periódico	periodic
el rastro	trail, trace
entretener	to entertain, to amuse (not divertir)
la tortuga	turtle
la tarifa	rate, tariff (not tasa)
estremecer	to shake, to shiver (not temblar)
demorar	to delay (d..)
de	of
el dulce	candy
eclesiástico	ecclesiastical
el alza	rise, increase (not aumento or incremento)
el pulso	pulse
el rector	rector
mutuo	mutual
la inscripción	inscription
el religioso	member of a religious order
el secuestro	kidnapping (not "el rapto"); hijack
el chileno	Chilean (person)
la eliminación	elimination
fascinar	to fascinate
la transparencia	transparency
la vocal	vowel
diferir	to defer (postpone); to differ
la probabilidad	probability
periodístico	journalistic
ortodoxo	orthodox
inquieto	worried (not preocupado)
licenciar	to license, to discharge
persistir	to persist
la portada	title page, cover; homepage
proveniente de	coming from (not "procedente de"); originating from
riguroso	rigorous
el cilindro	cylinder
adorar	to adore
el aviso	notice, warning (not "la advertencia"); advert
el embarazo	pregnancy
la extinción	extinction
el estrecho	strait
bloquear	to block
la reelección	reelection
sergio	sergio
tamaño	such a big, so big a
el psicólogo	psychologist
racional	rational
el porvenir	future (not futuro)
el peruano	Peruvian (person)
el marcador	scoreboard; highlighter pen (Lat Am)
verter	to pour
teñir	to dye
la prevención	prevention
bruto	ignorant
el ayudante	assistant (not asistente)
la aldea	village
la caballería	cavalry
el certamen	competition (not "la competición"), contest
el frijol	bean (f..)
crudo	raw
el pionero	pioneer
suavemente	gently
la seña	sign, gesture (not signo or señal)
el retraso	delay (not "la demora")
el nombramiento	appointment, nomination
volcánico	volcanic
querer	to want, to love, to like
geológico	geological
extremadamente	extremely (not sumamente)
erguir	to erect
el ademán	gesture (not gesto)
el as	ace
arrebatar	to snatch
el cereal	cereal
la cocaína	cocaine
concretar	to concrete
el cumpleaños	birthday
disimular	to cover up, to conceal (d..), to dissemble
el determinante	determinant
el desplazamiento	displacement
suscribir	to sign (a formal document) (not firmar)
reservado	reserved
referente	regarding
guatemalteco	Guatemalan
la municipalidad	municipality (not municipio)
mensual	monthly
la narrativa	narrative
el noble	nobleman
la inclinación	inclination
susana	susan
sereno	serene
procesar	to process
la pirámide	pyramid
la corbata	tie (clothing), necktie
exagerar	to exaggerate
fotográfico	photographic
el comunismo	communism
la cercanía	closeness
el ascensor	elevator
atmosférico	atmospheric
la vereda	path (v..)
verificar	to verify
la ventura	(good) fortune (not fortuna)
el terminal	terminal (electrical; computer)
cinematográfico	movie (Adj.)
la ganadería	stockbreeding
enredar	to get tangled up
costoso	costly
delicioso	delicious
la princesa	princess
gratuito	free, gratuitous, unfair
el láser	laser
la injusticia	injustice
el nacionalismo	nationalism
el molde	mold  (in art, cooking)
Olimpia	Olympia
la indiferencia	indifference
lateral	side, lateral
irlandés	Irish
la imprenta	printing (the activity); printing press; printing house
la hormiga	ant
sentimental	sentimental
el tramo	section (not "la sección"), stretch, span; flight (of stairs)
tímido	shy, timid
la víspera	eve
la suspensión	suspension
el récord	record
repleto (de)	packed (with), filled (with)
prevalecer	to prevail
la perla	pearl
el grabado	engraving
el gusano	worm
la maniobra	maneuver
la expulsión	expulsion
el borracho	drunkard
acertar	to guess right
el atardecer	dusk (a.., not "el anochecer"), evening
la coincidencia	coincidence (temporal, not random) (not casualidad); agreement
frágil	fragile
el demócrata	democrat
compacto	compact
el bigote	mustache
la acera	sidewalk, pavement
natal	native (not "nativo"), home; of or related to birth
presenciar	to witness
el vicio	vice
unificar	to unify
la procesión	procession
el párpado	eyelid
satisfactorio	satisfactory
obvio	obvious
el neutrón	neutron
materno	motherly
Miguel	Michael
Catalina	Catherine
la gala	gala
flexible	flexible
ficticio	fictitious
el diamante	diamond
desbordar	to overflow
la comodidad	comfort
agravar	to aggravate
la niñez	childhood (n...)
la minería	mining industry
informático	(of the) computer, (related to the) computer
resbalar	to slip (not "deslizar")
retomar	to take back again
el partidario	supporter
la plantación	plantation, planting
la privatización	privatization
el rescate	rescue
la mecánica	mechanics
el banquero	banker
criminal	criminal (not "penal")
exiliar	to exile
la esclavitud	slavery
contaminar	to contaminate
la deficiencia	deficiency
el montaje	assembly (mechanical process), assembling
la sabiduría	wisdom
perfeccionar	to perfect
la tolerancia	tolerance
el traslado	transfer (not transferencia)
la tregua	truce
registrado	registered
desencadenar	to unchain, to trigger
el elefante	elephant
fértil	fertile
el fuerte	fort
el ganadero	rancher (not ranchero)
el conquistador	conqueror
alternativo	alternative
el chorro	jet, spurt, stream
enfriar	to cool
reparar	to repair (not arreglar)
el recorte	cutting
el sedimento	sediment
interrogar	to interrogate
la incorporación	incorporation
molesto	annoying
la modernización	modernization
místico	mystic
la marea	tide
fabuloso	fabulous
la cueva	cave
debatir	to debate
coordinar	to coordinate
el compatriota	compatriot
tolerar	to tolerate
la variable	the variable
bordar	to embroider
fiel	faithful
la sequía	drought
la sustitución	replacement (not "el reemplazo"), substitution
retratar	to paint a portrait of
el limón	lemon
el intervalo	interval
el lápiz	pencil
la ginebra	gin
ilícito	illicit
insólito	unusual (not inusual)
la raya	line (not fila or línea)
continuamente	continually
la cotización	price, quotation, value (c...)
el abrigo	coat
el adversario	adversary
velar	to watch over (not vigilar)
vago	lazy (v...)
la tontería	nonsense, silly thing (not "el disparate" or "la sandez")
el whisky	whisky
tierno	tender
el atractivo	attractiveness
la cadera	hip
el dióxido	dioxide
silvestre	wild
influyente	influential
graduar	to graduate
el hígado	liver
inconsciente	unconscious
sincero	sincere
el dialecto	dialect
el constructor	builder
la financiación	funding
genial	brilliant, great (not magno)
el encargado	person in charge, manager
la bestia	beast
la clausura	closing, closure (not cierre)
asimilar	to assimilate
tenso	tense
la brigada	squad (b...)
el formato	format
la reja	grille/grill, (metal) bars
remediar	to remedy
persa	Persian
la pasta	pasta
la iluminación	lighting
la mención	mention
moderado	moderate (not "módico")
narrativo	narrative
la localización	location (not localidad or ubicación)
incómodo	uncomfortable
la ironía	irony
replicar	to answer back, to reply (not contestar or responder)
el cigarro	cigarette (not cigarrillo)
ardiente	ardent
apresurar	to hurry up
el apartamento	apartment (US), flat (UK)
voltear	to turn over
alternar	to alternate
la alerta	alert
el comunicado	statement, announcement (not anuncio)
el bulto	bulk (not "el grueso")
Beatriz	Beatrix
espantoso	horrific (e...)
la seriedad	seriousness
la sonata	sonata
sofisticado	sophisticated
partidario	in favor of; supportive; favorable
la inocencia	innocence
intercambiar	to exchange
miserable	miserable
la porcelana	porcelain
revolver	to stir, turn
enojar	to anger, to irritate (Lat Am) (not "enfadar")
el escaño	seat (political), bench
la estética	aesthetics
la documentación	papers (not "los papeles"), documentation
el carnaval	carnival
alquilar	to rent
apretado	tight (not "estrecho"), cramped
salino	saline
repentino	sudden (not "súbito")
recobrar	to recover (not "recuperar" or "convalecer")
gris	gray/grey
la venganza	revenge
trepar	to climb (not "escalar")
heroico	heroic
la incidencia	incident (not incidente or suceso)
Lucas	Lucas
remitir	to remit
el rocío	dew
radicar	to stem from
el adorno	ornament (not "el ornamento")
el estallido	explosion (not explosión)
la gasolina	gasoline
Fernanda	Fernanda
coronar	to crown
el barroco	Baroque period
la boleta	ticket, pass, entry (b.., not billete or boleto)
profundizar	to deepen
la revuelta	uprising, revolt (not levantamiento)
la nacionalidad	nationality
oceánico	oceanic
gisela	giselle
la inauguración	inauguration
la manga	sleeve, water-hose, pipe
el sufragio	suffrage
el representante	representative
complementario	complementary
Bach	Bach
decretar	to decree
la detención	arrest (not "el arresto")
la demostración	demonstration
el futbolista	soccer player
ambicioso	ambitious
recaer (en)	to have a relapse
sudar	to sweat
sintetizar	to synthesize
el parlamentario	parliamentarian
la patada	kick
Leonardo	Leonard
el teólogo	theologian
el tenis	tennis
la traición	betrayal, treachery; treason
hacer	to do, to make
el pleno	plenary
el azufre	sulphur
el caucho	rubber (c...)
complacer	to please (not agradar)
el comprador	buyer
la carreta	cart
animado	lively
furioso	furious
el convento	convent
duplicar	to duplicate
el semestre	semester
la secta	sect
rozar	to brush, brush against, graze
el lío	mess
el televisor	television (device)
el triángulo	triangle
el nutriente	nutrient
ilustre	distinguished (i...)
secuestrar	to kidnap (not "raptar"); to hijack
disfrazar	to disguise, to dress up
Esteban	Stephen
el aniversario	anniversary
la acumulación	accumulation
la advertencia	warning (not "aviso")
la cobertura	coating, coverage
configurar	to configure
el cartón	cardboard (stiff material); carton
el capricho	whim
la especulación	speculation
el servidor	servant (not sirviente)
sonriente	smiling
rítmico	rhythmic
regular	regular
el peón	laborer
paraguayo	Paraguayan
razonable	reasonable
imaginario	imaginary
el inca	Inca
la noción	notion
insoportable	unbearable
públicamente	publicly
pegado	stuck, glued
solemne	solemn
contrastar	to contrast
la frustración	frustration
la caricia	caress
considerablemente	considerably
cómico	comic
la aurora	dawn (not alba, amanecer, or madrugada)
la abeja	bee
el alga	seaweed
el alba	dawn (not amanecer, aurora, or madrugada)
la flauta	flute
extinguir	to extinguish
espantar	to frighten, to scare (not asustar)
constituyente	constituent
el divorcio	divorce
la sopa	soup
el reportaje	article (not artículo), story, report
reprimir	to repress
plácido	placid
Praga	Prague
previamente	previously (not anteriormente)
el instrumental	instruments, tools, equipment (singular)
el hablante	speaker (not "el orador")
la granja	grange, farm (not finca)
la tortura	torture
el reportero	reporter, TV news correspondent
el rock	rock (music)
la silueta	figure, shape, form, silhouette
sobrepasar	to surpass, to exceed (not exceder)
dinámico	dynamic
el coraje	courage
coser	to sew
enormemente	enormously
la excusa	excuse
almorzar	to have lunch
adherir	to adhere
la cima	top, summit, peak (not cumbre)
competitivo	competitive
el conservatorio	conservatory
la careta	mask (not máscara)
el campamento	camp
el alivio	relief (from pain or worry)
la erupción	eruption
esencialmente	essentially
el contorno	contour, outline
divisar	to make out
la previsión	precaution, foresight
el portador	carrier, bearer
la paja	straw
huy	ouch
el laberinto	labyrinth
lamentablemente	regrettably
el ion	ion
inocente	innocent
indefinido	undefined
el oriental	Easterner; Oriental (person); Uruguayan (person)
el oyente	listener
el chocolate	chocolate
el textil	textile
el tranvía	streetcar, tram
la tapa	lid
volcar	to knock over (not "tumbar")
ansioso	anxious, eager
arriesgar	to risk
embarcar	to embark
el resumen	summary
recubrir	to coat, to cover, to apply a coat to (r..)
el jugo	juice (not zumo)
germánico	germanic
magno	great (not genial)
sordo	deaf
la plancha	iron (for clothes); griddle/pan (for cooking on a flat metal surface)
la aproximación	approximation
la combustión	combustion
el tinte	dye
la textura	texture
el cómplice	accomplice
la ceja	eyebrow
Bulgaria	Bulgaria
la cabecera	headboard
el bono	voucher; (bus) pass; bond (finance)
el aislamiento	isolation; insulation
económicamente	financially
francamente	frankly
moro	Moorish
el humano	human being
impartir	to impart
ilustrar	to illustrate
el invasor	invader
Isaac	Isaac
el indicio	sign, indication (i.., not "la indicación")
hervir	to boil
la negativa	denial
el malestar	discomfort (not "la incomodidad")
súbito	sudden  (not "repentino")
reservar	to reserve
el saber	knowledge (not conocimiento)
aislar	to isolate
la alarma	alarm
acuático	aquatic
la caridad	charity
trescientos	three hundred
la calificación	mark, grade, rating
la araña	spider
deteriorar	to deteriorate
el rol	role (not "papel")
el pigmento	pigment
predecir	to predict
la merced	mercy (not piedad)
el isótopo	isotope
insinuar	to insinuate
el matemático	mathematician
liderar	to lead (not "dirigir")
Leopoldo	Leopold
libremente	freely
el sólido	solid
cortés	courteous, polite
enloquecer	to go crazy (not "volverse loco"), to drive crazy
enfocar	to focus
la balanza	scales (not "la báscula")
bárbaro	barbaric
la bicicleta	bicycle
la brisa	breeze
budista	buddhist
la catástrofe	catastrophe
el cinturón	belt
el aula	classroom
arrugar	to crease
el descontento	discontent
el desconocido	stranger, unfamiliar person (not extraño)
el susto	fright, scare
recostar	to lean
planificar	to plan (not planear)
Nigeria	Nigeria
el optimismo	optimism
hereditario	hereditary
el guante	glove
el inocente	innocent (Noun)
la inestabilidad	instability
la pupila	pupil (of the eye)
descargar	to unload; to download
digital	digital
el ecosistema	ecosystem
constructivo	constructive
la autorización	authorization
comportar	to entail
la urna	urn
el trayecto	journey (not recorrido or viaje)
la vitamina	vitamin
la autopista	highway, freeway (not carretera)
el consorcio	consortium
el cuarteto	quartet
el procurador	attorney, lawyer (not abogado)
manipular	to manipulate
la motivación	motivation
migratorio	migratory
la ladera	hillside
la lealtad	loyalty
gramatical	grammatical
el gitano	gypsy
pictórico	pictorial
reportar	to report (not informar)
enfatizar	to emphasize, to stress (e...)
el declive	decline
deducir	to deduce
el domicilio	residence (not "la residencia"), home, address
congelar	to freeze (food)
el conejo	rabbit
la chimenea	chimney
el bote	container, jar, can, tin (not lata); small boat
vegetal	vegetable (of plants)
el terrorista	terrorist
la capacitación	training (education) (not entrenamiento)
el arco	arch
agradar	to please (not complacer)
la anatomía	anatomy
discurrir	to pass, to flow, to roam, to concoct
decidido	determined, resolute (not determinado or resuelto)
convivir	to live together
equipar	to equip
filtrar	to filter
el rollo	roll (as in: toilet roll; roll of body fat); scroll
respetuoso	respectful
el resplandor	brightness, glare (not brillo)
soso	dull, boring (not "aburrido")
porteño	from the city of Buenos Aires
propio	own
incidir (en)	to stress, emphasize [esp. a theme or topic] (i...)
iniciado	initiated
húngaro	hungarian
la grandeza	greatness
el mango	handle (e.g. knife, pan) (not "picaporte")
privilegiado	privileged
el sirviente	servant (not servidor)
la sílaba	syllable
fundamentar	to found, to base, to establish (f.., not "fundar")
el duelo	mourning (not "el luto"), duel
la verdura	vegetable (v.., not "el vegetal")
la abundancia	abundance
la tentación	temptation
la valoración	valuation
vocal	vocal
vibrar	to vibrate
la vibración	vibration
venezolano	venezuelan
ahorrar	to save (money)
automáticamente	automatically
el asesino	murderer
dimitir	to resign (not "renunciar")
escocés	Scottish
el estatuto	statute
la rotación	rotation
productor	producing
la porción	portion
la pureza	purity
el desnudo	nude
conducir	to conduct, drive, manage
decidir	to decide
comprender	to comprehend, understand (not entender)
necesitar	to need
preferir	to prefer
dormir	to sleep
andar	to walk, to go (a...)
fuerte	strong
llorar	to cry, to weep
contener	to contain
reducir	to reduce
descubrir	to discover
imaginar	to imagine
crecer	to grow
mal	bad, wrong
justo	just, fair
cumplir	to fulfill, to comply
típico	typical, characteristic
el empate	tie (game)
emocionar	to excite, to thrill, to move (feelings)
fingir	to feign, to pretend
animal	animal (Adj.)
la muestra	indication (m..), sign, proof, demonstration, sample, model, pattern
la figura	figure, shape
amanecer	to dawn; to wake up
ganar	to win
el cabo	cape [geography]
la película	film
abril	April
fácil	easy
agosto	August
en	in, inside; on, on top of
extraño	strange (not "raro")
noviembre	November
la trama	plot, storyline (not " el argumento")
el nene	baby (not bebé)
el camino	track (c..); road
el baño	bathroom
actual	current, present
la voluntad	will, willpower
siguiente	following, after
el trago	alcoholic drink
la lengua	tongue, language
la mañana	morning, tomorrow
el clima	climate
el cargo	charge, position
permanecer	to remain, to stay [p...]
el avión	airplane
la línea	line (not fila or raya)
casar	to marry
pesar	to weigh
llenar	to fill
después	after
la reunión	meeting (not junta)
traer	to bring
causar	to cause (not ocasionar)
el apellido	surname
el tren	train
la plaza	(town) square
demostrar	to demonstrate, show
la residencia	residence (not "el domicilio")
aparecer	to appear
el cuadro	square, painting, bed (c...)
relacionar	to relate, to connect, to link
soler	to usually/customarily do something, in the habit of doing something
la teoría	theory
la empresa	company (not "la compañía"), enterprise
la espada	sword
el cerebro	brain
estar	to be (temporary qualities/states, location, feeling)
bastar	to be enough
catorce	fourteen
la pareja	couple (not "par")
abrir	to open
la raza	race (ethnicity)
moreno	brunette; dark-skinned
propiamente	properly (p...)
mandar	to send, to command, to order
la cuadra	block (in a neighborhood) (not "la manzana")
el funcionario	functionary, civil servant
doblar	to double, to fold, to bend, to turn
bajo	short, low
el fútbol	football, soccer
manejar	to manage, drive, handle
estadounidense	American (not americano)
el ambiente	environment, atmosphere (not entorno)
suponer	to suppose, to assume
demás	(the) rest of, (the) others (No Article)
viejo	old [v...]
el sexo	sex, gender
el título	title, college degree
el bar	bar, pub
el amigo	friend
conocimos (a una persona)	we met (a person)
según	according to (not "de acuerdo con")
profundo	deep (not hondo)